anderer / anderes / andere	autre
das ist etwas anderes	c'est autre chose

vor / davor / vorher	avant
vor drei Uhr	avant trois heures
ein Tag vorher	un jour avant
vor allem	avant tout

blau	bleu
sie hat ein blaues Auto gekauft	elle a acheté une voiture bleue

das Flugzeug	l'aviant
mit dem Flugzeug fliegen	aller en aviant

viel	beaucoup
sie hat viele Bücher	elle a beaucoup de livres
das gefällt mir sehr	j'aime beaucoup ça

mit	avec
sie ist mit ihm gekommen elle est venue avec lui

haben	avoir
ich habe viele Freunde	j'ai beaucoup d'amis

der Bus	l'autobus
mit dem Bus fahren	prendre l'autobus
die Bushaltestelle	l'arrêt d'autobus

schön	beau / beau / beaux / bel / belle / belles
das Wetter ist schön	il fait beau

trinken	boire
sie hat Wein getrunken	elle a bu du vin

der April	l'avril
im April	en avril
der erste April / am ersten April	le premier avril
der fünfzehnte April	le quinze avril

der Herbst	l'automne
im Herbst	en automne

die Meinung	l'avis
meiner Meinung nach	à mon avis
was ist Ihre Ansicht?	quel est votre avis?
er ist anderer Ansicht	il est d'un autre avis

auch	aussi
ich weiß die Antwort auch	je connais aussi la réponse
ich auch	moi aussi
du auch	toi aussi

weiß	blanc / blanche
obwohl	bien que
obwohl es regnet, geht er spazieren	bien qu'il pleuve, il se promène

bald	bientôt
bis bald	à bientôt

das Kind	l'enfant
wie viele Kinder hat sie?	combien d'enfants a-t-elle?

die Enkelkinder	les petits-enfants
meine Großeltern haben zehn Enkelkinder	mes grands-parents ont dix petits-enfants
die Enkelin / die Enkeltochter	la petite-fille
der Enkel / der Enkelsohn	le petit-fils

gelb	jaune
welche Farbe hat dein Auto? Gelb	de quelle couleur est ta voiture? Jaune

wenig	peu
er hat wenig Geld	il a peu d'argent
sprechen Sie Französisch? Ja, ein bisschen	parlez-vous français? Oui, un peu
nach und nach	peu à peu

gesund	sain
die Gesundheit	la santé
auf Ihr Wohl!	à votre santé / à la vôtre!
Prost!	santé!

sprechen	parler
ich habe mit Paul gesprochen	j'ai parlé avec Paul
ich habe von diesem Buch gesprochen	j'ai parlé de ce livre
sprechen Sie Französisch?	parlez-vous français?

vier	quatre
er hat vier Autos	il a quatre voitures
wann / als	quand
wann gehst du?	quand pars-tu?
ich traf ihn, als er das Haus verließ	je le rencontrai quand il quittait la maison

voll	plein
la bouteille est pleine
der Koffer ist voller Geld	la valise est pleine d'argent

hören	entendre
ich hab nicht gehört, was er gesagt hat	je n'ai pas entendu ce qu'il a dit
ich habe es im Radio gehört	je l'ai entendu à la radio

zwischen	entre
das Buch liegt zwischen der ersten und fünften Schachtel	le livre est entre la première et la cinquième boîte
wir reisen zwischen fünf und sechs Uhr ab	nous partirons entre cinq et six heures

lassen	laisser
lass ihn gehen	laisse-le partir

die Eltern	les parents
meine Mutter und mein Vater sind meine Eltern	ma mère et mon père sont mes parents

die Kirche	l'église
in die Kirche gehen	aller à l'église

schreiben	écrire
hast du schon den Brief an Pierre geschrieben?	as-tu déjà écrit la lettre à Pierre?

noch	encore
sie sind noch nicht angekommen ils ne sont pas encore arrivés
noch mal	encore une fois

in / im / nach	en
im Jahr 2008	en deux mile huit
ich wohne in Frankreich	j'habite en France
ich fahre nach Frankreich	je vais en France

ein Schüler un élève
eine Schülerin	une élève
wie viele Schüler gehen in diese Schule?	combien d'élèves fréquentent cette école?

informieren	informer
er hat mich informiert, dass sie um zwei Uhr ankommen	il m'a informé qu'ils viendraient à deux heures
die Information	l'information
wir haben keine Informationen	nous n'avons pas d'informations

sich interessieren	s'intéresser 
das interessiert mich nicht	ça ne m'intéresse pas
das Interesse	l'intérêt
interessant	intéressant

niemals	jamais
ich war noch nie in Paris	je n'ai jamais été à Paris

die Großmutter	la grand-mère
meine Großmutter lebt in Amerika	ma grand-mère vit en Amérique
der Großvater	le grand-père
die Großeltern	les grands-parents

groß	grand
das Haus ist groß	la maison est grande

der Kopf	la tête
sich den Kopf zerbrechen	se casser la tête

schrecklich	terrible
es gab einen schrecklichen Unfall	il y a eu un accident terrible

halten	tenir
sie hielt ein Buch in der Hand	elle tenait un livre à la main

die Zeit / das Wetter	le temps
ich habe keine Zeit	je n'ai pas le temps
die ganze Zeit	tout le temps
gleichzeitig / zur gleichen Zeit	en même temps
wie ist das Wetter?	quel temps fait-il?

das Taxi	le taxi
ein Taxi rufen	appeler un taxi
ein Taxi nehmen	prendre un taxi

die Mutter	la mère

der Vater	le père

die Eltern	les parents

der Sohn	le fils

heißen	s'appeler
wie heißen Sie? Ich heiße Jean	comment vous appelez-vous? Je m'appelle Jean

die Tochter	la fille

die Kinder	les enfants

der Junge 	le garçon

das Mädchen	la jeune fille

der Bruder	le frère

mein jüngerer Bruder	mon frère cadet

die Schwester	la sœur

meine ältere Schwester	ma sœur aînée

die Geschwister	les frères et sœurs

der Großvater	le grand-père

die Großmutter	la grand-mère

die Großeltern	les grands-parents

der Enkel	le petit-fils

die Enkelin	la petite-fille

die Tante	la tante

der Cousin	le cousin

die Kusine	la cousine

der Neffe	le neveu

die Nichte	la nièce

der Ehemann	le mari

die Ehefrau	la femme

das Ehepaar	le couple

der Schwiegersohn	le gendre

die Schwiegertochter	la belle-fille

der Schwiegervater	le beau-père

die Schwiegermutter	la belle-mère

der Schwager	le beau-frère

die Schwägerin	la belle-sœur

ein Freund	un ami

eine Freundin	une amie

der Bräutigam	le marié

die Braut	la mariée

erklären	expliquer
können Sie mir das Problem erklären?	pouvez-vous m'expliquer le problème?
die Erklärung	l'explication
ich habe keine Erklärung	je n'ai pas d'explication

das Beispiel	l'exemple
zum Beispiel	par exemple
entschuldigen	excuser
bitte entschuldigen Sie, können Sie mir den Weg zum Eiffelturm zeigen?	excusez-moi, pouvez-vous me montrer le chemin de la Tour Eiffel?
die Entschuldigung	l'excuse

sein	être
ich bin aus Paris	je suis de Paris
das Buch gehört mir	le livre est à moi
ich bin krank gewesen	j'ai été malade

sterben	mourir
sie ist 1950 gestorben	elle est morte en 1950
der Tod	la mort
tot	mort

fünf	cinq
er hat fünf Autos	il a cinq voitures

singen	chanter
falsch singen	chanter faux
richtig singen	chanter juste
das Lied	la chanson

fünfzig	cinquante
mein Vater ist fünfzig Jahre alt	mon père a cinquante ans

ändern / wechseln	changer
er hat seine Meinung geändert	il a changé d'avis
Dollars in Euro wechseln	changer des dollars en euros
die Veränderung / der Wechsel	le changement

klar	clair
das ist klar	c'est clair

so sehr	tellement
mögen Sie den Wein? nicht so sehr	aimez-vous le vin? pas tellement
sie ist so nett	elle est tellement gentille

die Polizei	la police
er wurde von der Polizei festgenommen	il a été arrêté par la police

die Tür	la porte
öffne die Tür	ouvre la porte
schließ die Tür	fermez la porte

regnen	pleuvoir
es regnet	il pleut
der Regen	la pluie

weinen	pleurer
er hat vor Freude geweint	il a pleuré de joie

vergessen	oublier
ich habe vergessen, meine Hausaufgaben zu machen	j'ai oublié de fair mes devoirs

Hallo, wie geht es dir?	Salut, comment ça va?
Wie geht es Ihnen?	Comment allez-vous?
Freut mich, Sie kennen zu lernen.	Enchanté de faire votre connaissance.

Wie heißt du?	Comment t'appelles-tu?
Wie heißen Sie?	Comment vous appelez-vous?
ich heiße Pierre	je m'appelle Pierre

Wo wohnst du?	Où habites-tu?
Wo wohnen Sie?	Où habitez-vous?
ich wohne in Paris	j'habite à Paris

Woher kommst du?	D'où viens-tu?
Woher kommen Sie?	D'où venez-vous?
ich bin aus Frankreich	je suis de France

Wie alt bist du?	Quel âge as-tu?
Wie alt sind Sie?	Quel âge avez-vous?
ich bin fünfzig Jahre alt	j'ai cinquante ans

Was machst du beruflich?	Quelle est ta profession?
Was machen Sie beruflich?	Quelle est votre profession?
ich bin Sekretärin	je suis secrétaire

Und wo arbeitest du?	Et où travailles-tu?
Und wo arbeiten Sie?	Et où travaillez-vous?
ich arbeite in einem Büro	je travaille dans un bureau

Wann wurdest du geboren?	Quand es-tu né?
Wann wurden Sie geboren?	Quand êtes-vous né?
ich wurde am fünfzehnten Juli zweitausendacht geboren	je suis né le qinze juillet deux milles huit

ich bin ledig	je suis célibataire
ich bin verheiratet	je suis marié
ich bin geschieden	je suis divorcé

der Witwer	le veuf
die Witwe	la veuve

Wie sind Ihre neuen Nachbarn?	Comment sont vos nouveaux voisins?
sie sind freundlich	ils sont aimables
sie sind unfreundlich	ils sont désagréable

Haben Sie Kinder?	Est-ce que vous avez des enfants?
ja, sie sind sehr brav	oui, ils sont très sages
ja, sie sind sehr unartig	oui, ils sont mal élevé

alle / alles / ganz	tout / tous / toute / toutes
kommt alle her	venez tous ici
das ist alles	c'est tout
den ganzen Tag	toute la journée
sie ist ganz zufrieden	elle est toute contente

immer	toujours
er ist immer freundlich	il est toujours gentil
immer und überall	toujours et partout
wie immer	comme toujours
schon immer	depuis toujours
für immer	pour toujours

berühren	toucher
mit der Hand berühren	toucher de la main
nicht berühren!	ne pas toucher!

früh	tôt
er ist früh gekommen	il est venu tôt

fallen	tomber
das Buch ist runtergefallen	le livre est tombé

auf Wiedersehen	au revoir
auf Wiedersehen sagen	dire au revoir
sich verabschieden	se dire au revoir

nichts	rien
ich konnte nichts sehen	je ne pouvais rien voir
nichts zu machen	rien à faire
sonst nichts	rien d'autre
überhaupt nichts	rien du tout
das macht nichts	ça ne fait rien
bitteschön	ce n'est rien

lachen	rire
da gibt es nichts zu lachen	il n'y a pas de quoi rire

rot	rouge
welche Farbe hat dein Auto? Rot	de quelle couleur est ta voiture? Rouge

die Straße	la rue
ich habe die Straße überquert	j'ai traversé la rue

da / dort	là
dort	là-bas
da oben	là-haut
darunter	là-dessous
darüber	là-dessus

der See	le lac
wir haben den See in einem Boot überquert	nous avons traversé le lac en bateau

hässlich	laid
laid est le contraire de beau

sich waschen	se laver
er hat sich die Hände gewaschen	il s'est lavé les mains
hast du dir die Zähne geputzt?	tu t'es lavé les dents?

der / die / das	le / la / les
der Junge	le garçon
die Jungen	les garçons
die Frau	la femme
die Frauen	les femmes
das Buch	le livre
die Bücher	les livres

überall	partout
sie steckt ihre Nase überall rein	elle met son nez partout

der Teil	la part
er hat den besten Teil bekommen	il a reçu la meilleure part

weil	parce que
ich kann nicht kommen, weil ich krank bin	je ne peux pas venir parce que je suis malade

die Seite	la page
öffnen Sie Ihre Bücher auf Seite drei	ouvrez vos livres à la page trois

bezahlen	payer
teuer bezahlen	payer cher
die Bezahlung	le paiement

die Katze	le chat
Pierre hat zwei Haustiere, eine Katze und einen Hund	Pierre a deux animaux domestiques, un chat et un chien

suchen	chercher
was suchst du?	qu'est-ce que tu cherches?

teuer / lieb	cher / chère
das ist teuer	ça coûte cher
meine liebe Marie	ma chère Marie

der Weg	le chemin
können Sie mir bitte den Weg zum Bahnhof zeigen?	pouvez-vous me montrer le chemin de la gare, s'il vous plaît?

heiß / warm	chaud
mir ist heiß / mir ist warm	j'ai chaud
es ist heiß / es ist warm	il fait chaud
die Hitze	la chaleur

der Freund	l'ami
die Freundin	l'amie
Pierre ist mein bester Freund	Pierre est mon meilleur ami

das Jahr	l'an
ich bin 20 Jahre alt	j'ai vingt ans
im Jahr zweitausendacht	en l'an deux mille huit
das Jahr (Zeitspanne)	l'année
jedes Jahr	chaque année
letztes Jahr	l'année dernière
nächstes Jahr	l'année prochaine

das Tier	l'animal
die Tiere	les animaux
auf einem Bauernhof gibt es viele Tiere	il y a beaucoup d'animaux dans une ferme

der August	août
im August	en août
der erste August	le premier août
der fünfzehnte August	le quinze août

rufen	appeler
er rief meinen Namen	il a appelé mon nom
heißen	s'appeler
wie heißen Sie? Ich heiße Jean	comment vous appelez-vous? Je m'appelle Jean

die Stunde / die Uhr	l'heure
wieviel Uhr ist es?	quelle heure est-il?
es ist fünf Uhr	il est cinq heures
um ein Uhr	à une heure
man braucht drei Stunden	il faut trois heures

glücklich	heureux
ich bin froh, Sie zu sehen	je suis heureux de vous voir
glücklicherweise	heureusement
glücklicherweise ist er nicht verletzt worden	heureusement, il n'a pas été blessé

gestern	hier
er ist gestern angekommen	il est arrivé hier

der Winter	l'hiver
im Winter	en hiver

der Mensch	l'homme
Pierre ist ein freundlicher Mensch	Pierre est un homme gentil

jemand	quelqu'un
jemand möchte Sie sprechen	quelqu'un a demandé à vous parler

die Tante	la tante
die Schwester meines Vaters ist meine Tante	la sœur de mon père est ma tante

spät	tard
bis später	à plus tard
spätestens	au plus tard

bitten	prier
bittesehr	je vous en prie
die Bitte	la prière

der Frühling	le printemps
im Frühling	au printemps

der nächste Tag	le lendemain
am folgenden Abend	le lendemain soir
von einem Tag zum anderen	de jour au lendemain

langsam	lent
er hat eine langsame Auffassungsgabe	il est lent à comprendre

der Brief	la lettre
hast du den Brief an Pierre geschrieben	as-tu écrit la lettre à Pierre

der Ort	les lieu
das Dorf ist ein berühmter Ort	ce village est un lieu célèbre

lesen	lire
haben Sie das Buch gelesen?	avez-vous lu ce livre?

hübsch	beau

hässlich	laid

schlank	mince

dick	gros

groß	grand

klein	petit

lebhaft	vif / plein de vie

ruhig	calme

interessant	intéressant

langweilig	ennuyeux

alt	vieux

jung	jeune

sie hat blaue Augen	elle a les yeux bleus

er trägt einen Bart	il porte la barbe

er trägt einen Schnurrbart	il porte la moustache

ich trage eine Brille	je porte des lunettes

sie ist blond	elle est blonde

er hat schwarze Haare	il a les cheveux noirs

er hat lange Haare	il a les cheveux longs

er hat kurze Haare	il a les cheveux courts

er hat krause Haare	il a les cheveux frisés

er hat glatte Haare	il a les cheveux lisses

warum	pourquoi
warum weinst du?	pourquoi pleures-tu?
warum nicht	pourquoi pas
deshalb	c'est pourquoi

können	pouvoir
könnten Sie mir helfen?	pourriez-vous m'aider?
ich kann nichts dafür	je n'y peux rien
darf ich Sie etwas fragen?	est-ce que je peux vous poser une question?

erster / erste / erstes	premier / première
an erster Stelle	en premier lieu
in erster Linie	en première ligne

nehmen	prendre
er hat mir mein Buch weggenommen	il m'a pris mon livre
sei vorsichtig!	prends garde!

fast / beinahe	presque
er kam fast zu spät	il était presque en retard
fast immer	presque toujours

das Problem	le problème
haben Sie das Problem gelöst?	avez-vous résolu ce problème?
kein Problem	pas de problème

nächster	prochain
nächster Samstag / am nächsten Samstag	samedi prochain
nächstes Mal	la prochaine fois
bis zum nächsten Mal	à la prochaine

der Professor	le professeur
wie heißt dein Mathematikprofessor?	comment s'appelle ton professeur de mathématiques?

eigen / sauber	propre
er trägt saubere Schuhe	il port des chaussures propres
ich habe es mit meinen eigenen Augen gesehen	je l'ai vu de mes propres yeux

vierzig	quarante
ich habe vierzig Euro ausgegeben	j'ai dépensé quarante euros

tragen	porter
bitte trag den Brief zur Post	porte la lettre à la poste, s'il te plaît
sie trägt eine gelbe Bluse	elle porte une blouse jaune

zweiter	second
öffnet eure Bücher, zweites Kapitel	ouvrez vos livres, second chapitre

vierzehn	quatorze
er ist vierzehn Jahre alt	il a quatorze ans

für	pour
das ist für dich	cela est pour toi

möglich	possible
so schnell wie möglich	le plus vite possible
die Möglichkeit	la possibilité
unmöglich	impossible

bekommen	recevoir
ich haben deinen Brief gestern bekommen	j'ai reçu ta lettre hier

zurückkommen	rentrer
sie ist früh zurückgekommen	elle est rentrée tôt

wiederholen	répéter
können Sie das Wort noch einmal wiederholen?	pouvez-vous répéter ce mot encore une fois?
die Wiederholung	la répétition

antworten	répondre
ich habe auf deinen Brief geantwortet	j'ai répondu à ta lettre
die Antwort	la réponse

null	zéro
drei Grad unter Null	trois degrés au-dessous de zéro

reichen / ausreichen / genug sein	suffire
das reicht jetzt aber!	ça suffit!

auf	sur
das Buch ist auf dem Tisch	le livre est sur la table

sicher	sûr
ich bin sicher, dass sie kommt	je suis sûr qu'elle viendra
sicher / natürlich	bien sûr

sich erinnern	se souvenir
ich erinnere mich gut an meine Ferien in Frankreich	je me souviens bien de mes vacances en France
ich erinnere mich, dass er mir das gesagt hat	je me souviens qu'il ma l'a dit
die Erinnerung	le souvenir

oft	souvent
wir treffen uns oft	nous nous recontrons souvent

Hast du heute Abend Zeit?	Tu es libre ce soir?

Wir könnten heute Abend ins Kino gehen	On pourrai aller au cinéma ce soir.

Hast du Lust, tanzen zu gehen?	As-tu envie d'aller danser?

Wie wär's mit einem Gläschen Wein?	Si on prenai un verre de vin?

Wollen wir einen Spaziergang machen?	On fait une promenade?

Super Idee!	Très bonne idée!

Einverstanden!	D'accord!

Um wie viel Uhr treffen wir uns?	On se recontre à quelle heure?

Um halb acht vor dem Kino?	À sept heures et demie devant le cinéma?

Nein, etwas später.	No, un peu plus tard.

Heute Abend habe ich leider keine Zeit.	Ce soir je n'ai malheureusement pas le temps.

Tut mir leid, ich gehe lieber ins Theater.	Désolé, je préfère aller au théâtre.

Ich tanze nicht gern.	Je n'aime pas danser.

Wie wär's mit morgen?	Et demain?

Morgen passt mir gut.	Demain, ça va.

Du hast schöne Augen.	Tu as de beaux yeux.

Danke, das ist sehr nett von dir.	Merci, cést très gentil de ta part.

Dein Französisch ist ausgezeichnet.	Ton français est excellent.

Kann ich dich bald wiedersehen?	Est-ce que je peux te revoir bientôt?

Ich begleite dich gern nach Hause.	Je t'accompagne volontiers à la maison.

Ich habe dich vermisst.	Tu m'as manqué.

betrachten	regarde
sehen Sie Sich das Foto an	regardez la photo
ich sehe fern	je regarde la télévision

der Tisch	la table
leg das Buch auf den Tisch	mets le livre sur la table

achtzig	quatre-vingts
einundachtzig	quatre-vingts-un
zweiundachtzig	quatre-vingts-deux

neunzig	quatre-vingts-dix
einundneunzig	quatre-vingts-onze
zweiundneunzig	quatre-vingts-douze

manchmal	quelquefois
er kommt manchmal	il vient quelquefois

das Bett	le lit
ins Bett gehen	aller au lit

das Buch	le livre
hast du das Buch gelesen?	as-tu lu ce livre?

lang	long / longue
das Zimmer ist drei Meter lang	la chambre fait trois mètres de long
die Länge	la longeur

lange	longtemps
vor langer Zeit	il y a longtemps
seit langem	depuis longtemps

schwer	lourd
der Tisch ist schwer	cette table est lourde

richtig / genau / gerade	juste
das ist richtig	c'est juste
er ist gerade abgefahren	il vient juste de partir
richtig / genau	justement
genau!	justement!

bis	jusqu'à
bis jetzt	jusqu'à maintenant
bis dass	jusqu'à ce que
bis ihr kommt	jusqu'à ce que vous veniez

der Tag	le jour
welcher Tag ist heute?	quel jour on est aujourd'hui?
jeden Tag	tous les jours
der Tag / der Tagesverlauf	la journée
ich war den Tag über bei Paul	j'ai passé la journée chez Paul
den ganzen Tag	tout la journée

das Mädchen	la jeune fille
Marie ist ein nettes Mädchen	Marie est une gentille jeune fille

Juni	juin
im Juni	en juin
der erste Juni	le premier juin
der fünfzehnte Juni	le quinze juin

Juli	juillet
im Juli	en juillet
der erste Juli	le premier juillet
der fünfzehnte Juli	le quinze juillet

der Garten	le jardin
Pierre ist im Garten	Pierre est dans le jardin

jung	jeune
Pierre ist ein junger Mann	Pierre est un jeune homme

Januar	janvier
im Januar	en janvier
der erste Januar	le premier janvier
der fünfzehnte Januar	le quinze janvier

Donnerstag	jeudi
letzter Donnerstag	jeudi dernier
nächster Donnerstag	jeudi prochain

der Herr	le monsieur
Zwei gut gekleidete Herren begleiten die Präsidentin.	Deux messieurs bien habillés accompagnent la présidente.

der Mann	l'homme
In der Nationalversammlung gibt es mehr Männer als Frauen.	À l'Assemblée, il y a plus d'hommes que de femmes.

Frau	madame
Während Ihres Praktikums wird sich Frau Martin um Sie kümmern.	C'est Madame Martin qui s'occupera de vous pendant votre stage.

die Frau	la femme
Es gibt ein Lied, das sagt, dass alle Frauen schön sind.	Il y a une chanson qui dit que toutes les femmes sont belles.

die Dame	la dame
Wer ist diese Dame neben dem Direktor?	Qui est cette dame à côté du directeur?

das Fräulein	la mademoiselle
Ich stelle Ihnen Fraulein Legrand, meine ältere Schwester, vor.	Je vous présente Mademoiselle Legrand, ma sœur aînée.

das Kind	l'enfant
Kinderreiche Familien haben selten mehr als vier Kinder.	Les familles nombreuses on rarement plus de quatre enfants.

der Junge	le garçon
Der erste Junge mit dem ich ausgegangen bin, hieß Thomas.	Le premier garçon avec qui je suis sortie s'appelait Thomas.

das Mädchen	la fille
Früher gingen Jungen und Mädchen nicht in die gleiche Schule.	Jadis, les garçons et les filles n'allaient pas à la même école.

nennen	appeler
Ich heiße Rudolf, aber man nennt mich Rudi.	Je m'appelle Rudolf, mais on m'appelle Rudi.

heißen	s'appeler
Wie heißt du? Ich heiße Jörg.	Comment tu t'appelles? Je m'appelle Jörg.

der Name	le nom
Martin ist der gebräuchlichste französische Name.	Martin es le nom français le plus courant.

der Nachname	le nom de famille
Mein Nachnahme ist Weber, aber Sie können Stefan zu mir sagen.	Mon nom de famille est Weber, mais vous pouvez m'appeler Stefan.

der Vorname	le prénom
Wie heißt du mit Vornamen?	C'est quoi, to prénom?

verheiratet	marié / mariée
Immer mehr nicht verheiratete Paare haben Kinder	De plus en plus de couples non mariés ont des enfants.

verwitwet	veuf / veuve
Mein Schwager ist verwitwet, aber er will nicht wieder heiraten.	Mon beau-frère est veuf, mais il ne veut pas se remarier.

getrennt	séparé / séparée
Sie sind seit fünf Jahren getrennt, aber sie treffen sich oft.	Ils sont séparés depuis cinq ans, mais ils se voient souvent.

die Person	la personne
Könnte ich einen Tisch für vier Personen reservieren?	Je pourrais réserver une table pour quatre personnes?

die Adresse	l'adresse
die Straße	la rue
die Hausnummer	le numéro de la maison

Um wie viel Uhr?	À quelle heure?
Um ein Uhr.	À une heure.
Um sieben Uhr.	À sept heures.
Um Viertel nach drei.	À trois heures et quart.
Um halb sieben.	À six heures et demie.
Um Viertel vor neun. À neuf heures moins le quart.
eine halbe Stunde früher	une demi-heure plus tôt
eine halbe Stunde später	une demi-heure plus tard

Montag	lundi
Dienstag	marid
Mittwoch 	mercredi
Donnerstag	jeudi
Freitag	vendredi
Samstag	samedi
Sonntag	dimanche

im Januar	en janvier
Februar	février
März	mars
April	avril
Mai	mai
Juni	juin
Juli	juillet
August	août
September	septembre
Oktober	octobre
November	novembre
Dezember	décembre

der Frühling	le printemps
der Sommer	un été
der Herbst	un automne
der Winter	un hiver
im Frühling	au printemps

im Oktober	en octobre
am ersten Oktober	en premier octobre
am fünfzehnten Oktober	en quinze octobre

das Auge	l'œil
die Augen	les yeux
sie hat grüne Augen	elle a les yeux verts

der Onkel	l'oncle
der Bruder meiner Mutter ist mein Onkel	le frère de ma mère est mon oncle

elfe	onze
mein Sohn ist elf Jahre alt	mon fils a once ans

das Ohr	l'oreille
ich habe Ohrenschmerzen	j'ai mal aux oreilles

der Flughafen	l'aeroport
er ist am Flughafen von Marseille angekommen	il est arrivé à l'aeroport de Marseille

kaufen	acheter
er hat ein neues Auto gekauft	il a acheté une nouvelle voiture

einverstanden	d'accord
ich bin einverstanden	je suis d'accord
ich stimme dir zu	je suis d'accord avec toi

der Unfall	l'accident
er hatte einen Unfall	il a eu un accident

in / nach / um	à
ich gehe nach Paris	je vais en Paris
in der Schule	à l'école
im Kino	au cinéma
um fünf Uhr	à cinq heures
diese Buch gehört Paul	ce livre est à Paul

erinnern	rappeler
darf ich Sie an Ihr Versprechen erinnern?	puis-je vous rappeler votre promesse?
sich erinnern	se rappeler
ich erinnere mich gut an meine Ferien in Frankreich	je se rappelle bien mes vacances en France

der Grund / das Recht	la raison
es gibt keinen Grund, böse zu sein	il n'y a pas de raison d'être flâché
du hast Unrecht	tu as tort
du hast Recht	tu as raison

was	quoi
an was denkst du?	à quoi penses-tu?
was gibt's Neues?	quoi de neuf?
womit kann ich Ihnen dienen?	en quoi puis-je vous servir?

fünfzehn	quinze
mein Sohn ist fünfzehn Jahre alt	mon fils a quinze ans

wer	qui
wer ist gekommen?	qui est venu?

das Gesicht	le visage
sie hat ein hübsches Gesicht	elle a un joli visage

schnell	vite
mach schnell!	vais vite!
so schnell wie möglich	le plus vite possible

da ist / da sind	voilà
da!	voilà!
da bin ich	me voilà
vor einem Jahr / seit einem Jahr	voilà un an

sehen	voir
er hat mich gesehen	il m'a vu

das Auto	la voiture
mit dem Auto fahren	aller en voiture

beenden / aufhören	finir
ich habe aufgehört zu lesen	j'ai fini de lire
das ist vorbei	c'est fini
das Ende	la fin
bis zum Ende	à la fin
Ende Januar	fin janvier

die Blume	la fleur
Rosen sind schöne Blumen	les roses sont de belles fleures

der Fluss	le fleuve
Paris liegt an einem Fluss, der Seine	Paris est situé sur un fleuve, la Seine

das Mal	la fois
dieses Mal	cette fois
jedes Mal	chaque fois
letztes Mal	la dernière fois
nächstes Mal	la prochaine fois
noch mal	encore une fois

verrückt / wahnsinnig	fou / fous / fol / fols / folle / folles
er ist total verrückt	il est complètement fou

oder	ou
hast du Pierre oder Colette gesehen?	as-tu vu Pierre ou Colette?

wo	où
wo wohnst du?	où habites-tu?
wohin gehst du?	où vas-tu?
woher kommst du?	d'où viens-tu?

ja	oui
hast du deine Hausaufgaben gemacht? Ja	as-tu fait les devoirs? Oui

öffnen	ouvrir
öffne bitte die Tür	ouvre la porte, s'il te plaît
geöffnet von neun bis fünf	ouvert de neuf à cinq heures

das Land	le pays
Frankreich ist ein wundervolles Land	la France est un pays merveilleux

lieb	brave
Er wird manchmal wütend, aber er ist ein lieber Kerl.	Il se met parfois en colère, mais c'est un brave type.

lieb / nett	gentil / gentille
Monique ist ein sehr liebes Mädchen.	Monique est une jeune fille très gentille.

gut / gütig	bon / bonne
Das ist eine wirklich gute Person, die hilft, wo sie nur kann.	C'est une personne vraiment bonne qui aide où elle peut.

freundlich	aimable
WärensSie so freundlich und würden diese Tür offen lassen?	Seriez-vous assez aimable pour laisser cette porte ouverte?

brav / artig	sage
Kinder, seid schön brav, ich bin in fünf Minuten wieder da.	Les envants, soyez bien sages, je revies dans cinq minutes.

der Charme	le charme
Man kann Charme haben, ohne schön zu sein.	On peut avoir du charme et ne pas être beau.

charmant	charmant / charmante
Man vergibt ihr all ihre Lügen, denn sie ist ja so charmant.	On lui pardonne tous ses mensonges, car elle est si charmante.

die Vernunft	la raison
Glücklicherweise hat die Vernunft ihn daran gehindert zu fahren.	Heureusement que la raison l'a empêché de conduire.

vernünftig	raisonnable
Also, sei vernünftig und mach keine Dummheiten!	Allons, sois raissonable et ne fais pas de bêtises.

ernst / ernsthaft	sérieux / sérieuse
Philippe ist ein sehr ernster junger Mann.	Philippe est un jeune homme très sérieux.

sympathisch	sympathique
Ich habe sie sofort sympathisch gefunden.	Je l'ai tout de suite trouvée sympathique.

ruhig	calme
Er bleibt ruhig, auch wenn es schlecht läuft.	Il reste calme même quand les choses vont mal.

still	tranquille
Ich hoffe, dass die Kinder heute still sind.	J'espère que les enfants seront tranquilles aujourd'hui.

komisch	comique
Die Szene war so komisch, dass alle Leute lauthals gelacht haben.	La scène était si comique que tout le monde a éclaté de rire.

der Mut	le courage
Nur Mut, wir sind schon fast am Ziel!	Allez, du courage, on est presque arrivés!

mutig	courageux / courageuse
Wenn ich mutiger wäre, würde ich ihr sagen, was ich denke.	Si j'étais plus courageux, je lui dirais ce que je pense.

die Dummheit	la bêtise
Er ist sich über seine Dummheit gar nicht im Klaren.	Il na se rend pas compte de sa bêtise.

dumm	bête
Das ist dumm! Ich habe wieder meine Schlüssel im Büro vergessen.	C'est bête! J'ai encore oublié mes clés au bureau.

böse / gemein	méchant / méchante
Er ist wirklich böse zu mir gewesen.	Il a été vraiment méchant avec moi.

feige	lâche
Er ist zu feige, um mir die Wahrheit ins Gesicht zu sagen.	Il est trop lâche pour me dire la vérité en face.

hassen	haïr
ich hasse ihn	je le hais

das Krankenhaus	l'hôpital / les hôpitaux
er wurde ins Krankenhaus gebracht	il a été amené à l'hôpital

acht	huit
mein Sohn ist acht Jahre alt	mon fils a huit ans

hier	ici
komm her!	viens ici!
bis hier	jusqu'ici

vor / es gibt	il y a
vor zwei Jahren	il y a deux ans
es gibt viele Probleme	il y a beaucoup de problèmes
was gibt's?	qu'est-ce qu'il y a?

der Unterschied	la différence
verschieden	différent
das ist anders	c'est différent

schwierig	difficile
das Problem ist schwer zu lösen	ce problème est difficile à résoudre
die Schwierigkeit	la difficulté

der Sonntag	le dimanche
letzten Sonntag	dimanche dernier
nächsten Sonntag	dimanche prochain
sonntags geht sie in die Kirche	le dimanche elle va à l'église

sagen	dire
was wollen Sie damit sagen?	que voulez-vous dire par cela?
das heißt	c'est-à-dire

zehn	dix
ich habe zehn Euro ausgegeben	j'ai dépensé dix euros
siebzehn	dix-sept
achtzehn	dix-huit
neunzehn	dix-neuf

der Arzt	le docteur
wenn du krank bist, werde ich dich zum Arzt fahren	si tu es malade je vais te conduire chez le docteur

der Fehler	la faute
das ist nicht meine Schuld	ce n'est pas ma faute

falsch	faux / fausse
das ist falsch	c'est faux

die Frau	la femme
Jeanne ist eine freundliche Frau	Jeanne est une femme gentille
Pierre ist mit seiner Frau Marie gekommen	Pierre est venu avec sa femme Marie

das Fenster	la fenêtre
er hat aus dem Fenster gesehen	il a regardé par la fenêtre

schließen	fermer
mach die Tür zu	ferme la porte

oben / darauf / darüber	dessus
wir haben auf und unter dem Tisch gesucht	nous avons cherché dessus et dessous la table
oberhalb von	au-dessus de
sein Haus liegt oberhalb der Stadt	sa maison se trouve au-dessus de la ville

zwei	deux
mein Sohn ist zwei Jahre alt	mon fils a deux ans
die beiden	tous le deux

vor	devant
das Auto steht vor dem Haus	la voiture est devant la maison

werden / become	devenir
was ist aus ihr geworden?	qu'est-ce qu'elle est devenue?

müssen / sollen	devoir
ich muss gehen	je dois m'en aller

wie	comment
wie sind Sie hergekommen?	comment est-ce que vous êtes venu ici?

anfangen	commencer
es fängt an zu regnen	il commence à pleuvoir
der Anfang	le commencement
am Anfang	au commencement

weil / da	comme
weil es regnet, komme ich nicht	comme il pleut, je ne viens pas
so	comme ça
so lala	comme ci, comme ça

wie viele	combien
wie viele Autos hast du?	combien de voitures as-tu?
den Wievielten haben wir heute?	on est le combien aujourd'hui?

die Sache / das Ding	la chose
das ist dasselbe	c'est la même chose

tausend	mille
tausendeins	mille un
tausenddreiundfünfzig	mille cinquante-trois
tausendsechshundertvierundvierzig	mille six cent quarante-quatre

der Monat	le mois
letzten Monat	le mois dernier
nächsten Monat	le mois prochain
jeden Monat	chaque mois

der Moment	le moment
einen Moment!	un moment!
in diesem Augenblick	en ce moment

die Welt	le monde
alle	tout le monde

Herr	monsieur
kennst du Herrn Laffont?	connais-tu Monsieur Laffont?
meine Damen und Herren	mesdames et messieurs

Ich lebe in einer Wohung.	J'habite dans un appartement.
und wir in einem Haus	et nous dans une maison

das Reihenhaus	la maison en bande
die Doppelhaushälfte	la maison jumelle
eine Mietwohnung	un appartement loué
eine Eigentumswohnung	un appartement en copropriété

ein Stockwerk	un étage
im dritten Stock	au troisième étage
der Wolkenkratzer	le gratte-ciel
ein Haus mit Lift	une maison avec ascenseur
eine Treppe	un escalier

in der Stadt	en ville
das Dorf	le village
das Stadtviertel	le quartier
am Stadtrand	en banlieue
auf dem Land	à la campagne

das Gesicht	le visage
Sein Gesicht kommt mir bekannt vor. Son visage me dit quelque chose.

das Gesicht / anderes Wort als visage	la figure
Er ist mit braun gebranntem Gesicht vom Skifahren zurückgekommen.	Il est revenu du ski avec la figure bronzée.

das Haar / die Haare	les cheveux
Zurzeit haben die Jungen eher kurze Haare.	En ce moment, les garçons ont plutôt les cheveux courts.

ähneln / gleichen	ressembler à
Sie gleicht mehr ihrem Vater als ihrer Mutter.	Elle ressemble plus à son père qu'à sa mère.

sich ähnlich sein / sich gleichen	se ressembler
Sie sind sich überhaupt nicht ähnlich.	Ils ne se ressemblent pas du tout.

hübsch	joli / jolie
Ich finde deine Schwester mit kurzen Haaren hübscher.	Je trouve ta sœur plus jlie avec les cheveux courts.

die Schönheit	la beauté
Sie ist zwar keine Schönheit, aber sie ist sehr nett.	Ce n'est pas un beauté, mais elle est très gentille.

schön	beau / bel / belle / beaux
Laurent ist nicht sehr schön, aber er ist charmant.	Laurent n'est pas très beau, mais il est charmant.

attraktiv / anziehend	attirant /attirante
Diese große blonde Frau ist wirklich sehr attraktiv.	Cette grande femme blonde est vraiment très attirante.

hässlich	laid / laide
Ludwig der elfte war angeblich sehr hässlich.	Louis XI était, paraît-il, très laid.

hässlich / anderes Wort als laid	moche
Ihr findet ihn hässlich? Also, mir gefällt er.	Vous le trouvez moche? Eh bien moi, il me plaît.

eine gute Figur haben	être bien fait / être bien faite
Auf diesem Foto hat sie wirklich eine gute Figur.	Elle est vraiment bien faite sur cette photo.

groß	grand / grande
De Gaule war so groß, dass er ein Spezialbett brauchte.	De Gaule était si grand qu'il lui falait un lit spécial.

klein	petit / petite
Edit Piaf war ganz klein.	Edith Piaf était toute petite.

dick	gros / grosse
Er ist nicht viel und trotzdem ist er dick.	Il ne mange pas beaucoup et pourtant il est gros.

dünn / mager	maigre
Du bist zu dünn, weil du nicht genug isst.	Tu es trop maigre, car tu ne manges pas assez.

schlank	mince
Topmodels sind nicht schlank, sie sind echt mager.	Les top-model ne sont pas minces, elles sont carrément maigres.

blass	pâle
Als er erfuhr, dass er in Gefahr ist, wurde er ganz blass.	Quand il a su qu'il était en danger, il est devenu tout pâle.

die Frisur	la coiffure
Ich dinde, dass dir deine neue Frisur sehr gut steht.	Je trouve que ta nouvelle coiffure te va très bien.

sich frisieren	se coiffer
Mit meinen Haaren brauche ich Stunden, um mich zu frisieren.	Avec ces cheveux, quand je me coivee, j'en ai pour des heures.

blond	blond / blonde
Sie ist ein Mädchen mit blauen Augen und blonden Haaren.	C'est une file aux yeux bleus et aux cheveux blonds.

dunkelhaarig / brünett / braun	brun / brune
Meine Frau ist dunkelhaarig, aber alle unsere Kinder sind blond.	Ma femme est brune, mais tous nos enfants sont blonds.

grauhaarig	aux cheveux gris
Der alte grauhaarige Mann da, ist das dein Großvater?	Ce vieil homme aux cheveux gris, c'est ton grand-père?

schwarzhaarig	aux cheveux noirs
Das ist das perfekte Make-up für schwarzhaarige Frauen.	C'est le maquillage parfait pour les femmes aux cheveux noirs.

rothaarig	roux / rousse
Nein, nicht alle Engländer sind rothaarig!	Non, tous les Anglais ne sont pas roux!

hell	clair / claire
Deine Krawatte ist zu hell für ein weißes Hemd.	Ta cravate est trop claire pour aller avec une chemise blanche.

dunkel	foncé / foncée
Bei einer Beerdigung trägt man eher dunkle Kleidung.	Lors d'un enterrement, on porte plutôt des vêtements foncés.

beschließen / entscheiden	décider
er beschloss zu gehen	il a décidé de s'en aller
die Entscheidung	la décision
eine Entscheidung treffen	prendre une décision

verbieten	défendre
es ist verboten zu rauchen	il est défendu de fumer

schon	déjà
sind sie schon angekommen?	sont-ils déjà arrivés?
es ist schon fünf Uhr	il est déjà cinq heures

morgen	demain
morgen früh	demain matin
morgen Abend	demain soir

fragen / bitten / verlangen	demander
sie wird am Telefon verlangt	on la demande au téléphone

der Zug	le train
den Zug nehmen	prendre le train
der Zug hat Verspätung	le train est en retard
den Zug verpassen	manquer le train

arbeiten	travailler
er muss hart arbeiten	il doit travailler dur
die Arbeit	le travail / les travaux

dreizehn	treize
er ist dreizehn Jahre alt	il a treize ans

dreißig	trente
ich bin dreißig Jahre alt	j'ai trente ans

sehr	très
sie ist sehr müde	elle est très fatiguée

der Berg	la montagne
wir haben unsere Ferien in den Bergen verbracht	nous avons passé nos vacances à la montagne

zeigen	montrer

das Motorrad	la moto
mit dem Motorrad fahren	aller à moto

natürlich / selbstverständlich	naturellement
ich komme natürlich	je viendrai, naturellement

schneien	neiger
es schneit	il neige
der Schnee	la neige

setzen / stellen / legen	mettre
leg das Buch auf den Tisch	mets le livre sur la table

Mittag	midi
heute Mittag	ce midi
es ist Mittag	il est midi
mittags / um 12 Uhr	à midi

wichtig	important
die Wichtigkeit	l'importance
das ist nicht wichtig	cela n'a pas d'importance

helfen	aider
er hat mir wirklich geholfen	il m'a vraiment aidé
die Hilfe	l'aide
mit seiner Hilfe	avec son aide

lieben / mögen	aimer
ich liebe dich	je t'aime
sie liest gern	elle aime lire
mögen Sie das dessert?	aimez-vous le dessert?
die Liebe	l'amour
mein Schatz	mon amour
um Himmels Willen	pour l'amour de Dieu / pour l'amour du ciel

so / dermaßen	ainsi
sozusagen	pour ainsi dire
und so weiter	et ainsi de suite

ungefähr	environ
sie ist vor ungefähr zwei Stunden abgereist	elle est partie il y a environ deux heures

Februar	février
im Februar	en février
der erste Februar	le premier février
der fünfzehnte Februar	le quinze février

die Tochter	la fille
mein Bruder hat drei Töchter	mon frère a trois filles

der Sohn	le fils
meine Tante hat drei Söhne	ma tante a trois fils

der Bruder	le frère
Pierre ist mein älterer Bruder	Pierre est mon frère aîné

der Bahnhof	la gare
ich habe ihn am Bahnhof getroffen	je l'ai recontrer à la gare

kalt	froid
mir ist kalt	j'ai froid
es ist kalt	il fait froid
die Kälte	le froid

der Junge	le garçon
Pierre ist ein kleiner Junge	Pierre est un petit garçon

behalten	garder
Sie können das Buch behalten	vous pouvez garder ce livre

leicht	léger / légère
das ist ein leichtes Gewicht	c'est un poids léger

März	mars

der Morgen	le matin
heute Morgen	ce matin
jeden Morgen	tous le matins
um drei Uhr morgens	à trois heures du matin
der Morgen / im Verlauf	la matinée
den ganzen Morgen	toute la matinée

schlecht	mauvais
das Wetter ist schlecht	il fait mauvais
schlecht / weh	mal
ich habe Kopfschmerzen	j'ai mal à la tête
mir ist schlecht	j'ai mal au cœur
das tut mir weh	ça me fait mal

gleich	même
das ist das Gleiche	c'est la même chose
ich selbst	moi-même
trotzdem	quand même
ich gehe trotzdem da hin	j'y vais quand même

das Meer	la mer
die Ostsee	la mer Baltique
die Nordsee	la mer du Nord

dann	alors
bis dahin	jusqu'alors

lernen / lehren	apprendre
er hat mir beigebracht zu lesen	il m'a appris à lire

nach	après
nach zwei Stunden	après deux heures
sie ist nach dir gekommen	elle est venue après toi

der Nachmittag	l'après-midi
heute Nachmittag	cet après-midi

der Baum	l'arbre
es gibt viele Bäume in diesem Garten	il y a beaucoup d'arbre dans ce jardin

danke	merci
vielen Dank	merci beaucoup
danke für deinen Brief	merci de ta lettre
Gott sei Dank!	Dieu merci!

Mittwoch	mercredi
letzten Mittwoch	mercredi dernier
nächsten Mittwoch	mercredi prochain

die Mutter	la mère
das ist die Mutter von Pierre	c'est la mère de Pierre

die Metro	la métro
die Metro nehmen	prendre la métro

gehen	aller
sie ist in die Schule gegangen	elle est allée à l'école
wie geht es dir?	comment vas-tu?
wie geht es Ihnen?	comment allez-vous?
wie geht's?	ça va?
weggehen	s'en aller
er geht weg	il s'en va

krank	malade
ich war krank	j'ai été malade
er wurde krank	il est tombé malade
die Krankheit	la maladie

unglücklich	malheureux / malheureuse
das Unglück	la malheur
Pech haben	avoir du malheur
leider / unglücklicherweise	malheureusement
leider ist er schon abgereist	malheureusement, il est déjà parti

essen	manger
jeden Abend esse ich im Restaurant	chaque soir je mange au restaurant

Dienstag	mardi
letzten Dienstag	mardi dernier
nächsten Dienstag	mardi prochain

der Ehemann	le mari
Colette ist mir ihrem Ehemann Pierre gekommen	Colette est venue avec son mari Pierre

links	à gauche
die Kirche ist links	l'église est à gauche
biegen Sie an der Ampel links ab	tournez au feu à gauche

Mai	mai
im Mai	en mai

die Hand	la main

jetzt	maintenant
können Sie mir sagen, was ich jetzt machen soll?	pouvez-vous me dire ce que je dois faire maintenant?

aber	mais
Peter ist nicht gekommen, aber seine Schwester	Peter n'est pas venu mais sa sœur

das Haus	la maison
im Haus sein	être à la maison
nach Hause kommen	rentre à la maison

die Leute	les gens
es waren viele Leute auf der Straße	il y avait beaucoup de gens dans la rue

freundlich	gentil / gentille
das ist freundlich von dir	c'est gentil de ta part
er war sehr freundlich zu mir	il étai très gentil avec moi

das Bein	la jambe
er hat sich das Bein gebrochen	il s'est cassé la jambe

Montag	lundi

Frau	madame
kennst du Frau Lefèvre?	connais-tu Madame Lefèvre?

die Kleidung	les vêtements
Ich nehme warme Kleidung mit, es könnte schneien.	J'emporte des vêtements chauds, il pourrait neiger.

die Mode	la mode
Es ist teuer, wenn man immer mit der Mode gehen will.	Ça coûte cher de vouloir être toujours à la mode.

elegant	élégant / élégante
Ein Mann muss nicht eine Krawatte tragen, um elegant zu sein.	Un homme peut être élégant sans orter une cravate.

sich anziehen	s'habiller
Ich ziehe mich an, dann bin ich fertig.	Je m'habille et je suis prête.

anziehen	mettre
Ich habe nichts anzuziehen.	Je n'ai rien à me mettre.

ausziehen	enlever
Mir ist zu warm, ich ziehe meine Jacke aus.	J'ai trop chaud, j'enlève ma veste.

sich ausziehen	se déshabiller
Ich bin ins Bett gegangen ohne mich auszuziehen.	Je me suis couchée sans me déshabiller.

tragen / anhaben	porter
Sie hat einen zu kurzen Rock an.	Elle porte une jupe trop courte.

anprobieren	essayer
Du musst das Kleid anprobieren, um zu sehen, ob es dir steht.	Il faut que tu essaies la robe pour voir si elle te va.

sich umziehen	se changer
Ich ziehe mich schnell um, damit ich mich nicht erkälte.	Je vais me changer en vitesse pour ne pas prendre froid.

stehen / passen	aller
Der Bart steht ihm sehr gut.	La barbe lui va très bien.

zusammenpassen	aller ensemble
Deine Hose und deine Bluse passen gut zusammen.	Ton pantalon et ton chemisier vont bien ensemble.

eng	étroit / étroite
Wie kann man nur so enge Jeans tragen?	Comment peut-on mettre des jeans aussi étroits?

weit	large
Der Mantel ist ihr zu weit.	Son manteau est trop large pour elle.

kurz	court / courte
So gehst du nicht in die Kirche, dein Rock ist viel zu kurz.	Tu ne vas pas à l'église ainsi, ta jupe est beaucoup trop courte!

lang	long / longue
Du bist aber elegant in diesem hübschen langen Kleid.	Que tu es élégante dans cette jolie robe longue!

die Schuhgröße	la pointure
Ich trage 42. Eine Schuhgröße, die schwer zu finden ist.	Je chausse du 42. C'est une pointure difficile à trouver.

die Kleidergröße / die Größe	la taille
Im Schlussverkauf finde ichnie meine Größe.	Pendent les solde, je ne trouve jamais ma taille.

der Mantel	le manteau
die Jacke	la veste
die Hose	la pantalon
die Jeans	le jean
das T-Shirt	le tee-shirt
der Pullover	le pull-over / le pull
das Kleid	la robe
der Rock	la jupe
die Shorts	le short
das Hemd	la chemise
die Bluse	le chemisier
der Anzug	le costume
der Strumpf	le bas
die Socke	le chaussette
der Schuh	la chaussure
der Schlafanzug	le pyjama
das Nachthemd	la chemise de nuit
der Slip	le slip
die Unterhose	la culotte
die Boxershorts	le caleçon
der Badeanzug	le maillot de bain
die Badehose	le slip de bain
der Bikini	le bikini

Dezember	décembre
im Dezember	au mois de décembre

schreien	crier
er schrie: "Hilfe, hilfe"	il a crié: "Au secours, au secours"

kurz	court
sie trug einen kurzen Rock	elle porte une jupe courte

laufen / rennen	courir
sie lief schnell	elle a couru vite

die Farbe	la couleur
welche Farbe hat dein Auto?	de quelle couleur est ta voiture?

von / aus	de
er kommt aus Frankreich	il vient de France
das ist das Buch von Marie	c'est le livre de Marie

leben	vivre
sie lebt in Frankreich	elle vit en France
das Leben	la vie
so ist das Leben	c'est la vie

alt	vieux / vieil
die Frau ist alt	cette femme est vielle

gefährlich	dangereux / dangereuse
Löwen sind gefährliche Tiere	les lions sont des animaux dangereux
die Gefahr	le danger

in / im	dans
im Zimmer	dans la chambre
in einer Stunde	dans une heure

Freitag	vendredi

kommen	venir
sie ist gekommen	elle est venue

die Wahrheit	la vérité
sag die Wahrheit!	dis la vérité!
wahr / richtig	vrai
wirklich	vraiment
es ist wirklich nicht sehr weit	ce nést pas vraiment loin

grün	vert
welche Farbe hat dein Auto? Grün	de quelle couleur est ta voiture? Verte

leer	vide
die Flasche ist leer	la bouteille est vide

schwarz	noir
es wird dunkel	il fait noir

auch nicht	non plus
bist du eingeladen? Ich auch nicht	es-tu invité? Moi non plus

ein / eine	un / une
ein Mann	un homme
eine Frau	une femme

eins, zwei, drei	un, deux, trois

das Fahrrad	la vélo
Fahrrad fahren	aller en vélo

bei / zu	chez
ich bin zu Hause	je suis chez moi
ich gehe zum Arzt	je vais chez le docteur

also / denn	donc
sag mal	dis donc
sagen Sie mal	dites donc
antworte doch!	réponds donc!
warum denn?	pourquoi donc?
was willst du denn?	que veux-tu donc?

geben	donner
gib mir das Buch	donne-moi ce livre

unter	dessous
er zog das Buch unter dem Bett hervor	il a pris le livre de dessous le lit
unterhalb von	au-dessous de
unter dreißig Jahren	au-dessous de trente ans

die Nase	le nez
es steht vor deiner Nase	tu as le nez dessus

die Haare	le cheveu / les cheveux
er hat schwarze Haare	il a des cheveux noirs

die Seite	le côté
die Schule ist auf der anderen Seite der Kirche	l'école est de l'autre côté de l'église

glauben	croire
ich glaube ihm	je le crois
ich glaube nichts davon	je n'en crois rien
an Gott glauben	croire en Dieu

nicht / nein	non
hast du deine Hausaufgaben gemacht? Nein	as-tu fait tes devoirs? Non

der Hund	le chien

warten	attendre
warten Sie bitte einen Moment	attendez un moment, s'il vous plaît

der Vater	le père
das ist der Vater von Pierre	c'est le père de Pierre

denken	penser
woran denkst du?	à quoi penses-tu?
der Gedanke	la pensée

während	pendant
während meiner Abwesenheit	pendant mon absence
während ich weg bin	pendant que je suis absent

die Nacht	la nuit
es ist Nacht	il fait nuit
es wird Nacht	la nuit tombe
bis spät in die Nacht	jusque tard dans a nuit
übernachten bei	passer la nuit chez

November	novembre

klein	petit
das Haus ist klein	la maison est petite

keiner	ne personne
hier ist keiner	il n'y a personne ici

die Familie	la famille
er hat eine große Familie	il a une famille nombreuse

der Arm	le bras
in die Arme nehmen	serrer dans ses bras

der Mund	la bouche
halt deinen Mund!	fermez ta bouche!


verlieren	perdre
ich kann die Tür nicht abschließen, weil ich meinen Schlüssel verloren habe	je ne peux pas fermer la porte parce que jái perdu ma clé
der Verlust	la perte

genug / ziemlich	assez
er hat genug Geld	il a assez d'argent
das Haus ist ziemlich klein	la maison est assez petite

vielleicht	peut-être
er ist vielleicht krank	il est peut-être malade
vielleicht ja	peut-être que oui

sich setzen	s'asseoir
sie hat sich gesetzt	elle s'est assise
sitzen	être asseoir
sitzen bleiben	reseter assis

die Angst	le peur
ich habe Angst vor ihm	j'ai peur de lui
ich habe Angst, dass er nicht kommt	j'ai peur qu'il ne vienne pas

neu	neuf / neuve
sein Auto ist ganz neu	sa voiture est toute neuve

neun	neuf
mein Sohn ist neun Jahre alt	mon fils a neuf ans

müde	fatigué
ich bin sehr müde	je suis très fatigué

nötig sein	falloir
man muss	il faut
man muss arbeiten	il faut travailler
du musst gehen	il faut que tu partes
wir brauchen Zeit	il nous faut du temps
das dauert drei Stunden	il faut trois heures

machen	faire
ich mache es sofort	je le fais tout de suite
das Wetter ist schlecht	il fait mauvais
das Wetter ist besser geworden	il fait meilleur
das macht nichts	ça ne fait rien
er lässt Paul hereinkommen	il fait entrer Paul

der Hunger	le faim
Hunger haben	avoir faim

die Art und Weise	le façon
auf diese Weise	de cette façon
so dass	de façon que
auf jeden Fall	de toute façon
ich komme auf jeden Fall	je viendrai de toute façon

einfach	facile
das ist nicht einfach	ce n'est pas facile

wütend / sauer	fâché
ich bin wütend auf ihn	je suis fâché contre lui

das / dieses	ça
wie geht's?	ça va?
so ist das	c'est ça

guten Abend	bonsoir
sie begrüßte mich mit "Guten Abend"	elle m'a salué avec "Bonsoir"

guten Tag	bonjour
er begrüßte mich mit "Guten Tag"	il m'a salué avec "Bonjour"

gut	bon / bonne
Pierre ist ein guter Freund	Pierre est un bon ami

gut / (Adverb)	bien
das ist gut	c'est bien

heute	aujourd'hui
heute ist Montag	aujourd'hui est lundi

wollen	vouloir
ich will, dass du sofort kommst	je veux que tu viennes tout de suite

plötzlich	tout à coup
ich schrieb einen Brief und plötzlich kam meine Mutter herein	j'écrivais une lettre et tout à coup ma mère entra

sofort	tout de suite
kommt sofort her!	venez tout de suite!

traurig	triste
er ist sehr traurig	il est très triste
die Traurigkeit	la tristesse

drei	trois
mein Sohn ist drei Jahre alt	mon fils a trois ans

dritter / drittes	troisième
ich habe ihn das dritte Mal getroffen	je l'ai recontré pour la troisième fois

zu / zu sehr	trop
das Haus ist zu groß	la maison est trop grande

sich befinden / finden	trouver
ich habe den Schlüssel gefunden	j'ai trouvé la clé
wie findest du das Buch?	comment tu trouves ce livre?

die Stadt	la ville
Paris ist eine wunderschöne Stadt	Paris est une ville merveilleuse

zwanzig	vingt
einundzwanzig	vingt et un
zweiundzwanzig	vingt-deux

sechzehn	seize
mein Sohn ist sechzehn Jahre alt	mon fils a seize ans

die Woche	la semaine
jede Woche	chaque semaine
letzte Woche	la semaine dernière
nächste Woche	la semaine prochaine

fühlen / riechen	sentir
sich gut fühlen	se sentir bien
sich schlecht fühlen	se sentir mal
schlecht riechen	sentir mauvais
gut riechen	sentier bon
das Gefühl	le sentiment

sieben	sept
es ist sieben Uhr	il est sept heures

September	septembre

nur / erst	seulement
wenn ich nur reich wäre	si seulement j'étais riche
er ist erst siebzehn Jahre alt	il a dix-sept ans seulement

die Schule	l'école
in die Schule gehen	aller à l'école

hören	écouter
ich höre die Nachrichten	j'écoute les informations

der Fuß	le pied
zu Fuß gehen	aller à pied

der Platz / die Stelle	la place
an deiner Stelle	à ta place

gefallen	plaire
bitte / ich bitte dich	s'il te plaît
bitte / ich bitte Sie	s'il vous plaît
das gefällt mir	ça me plaît

das Wasser	l'eau
haben Sie ein Glas Wasser für mich?	avez-vous un verre d'eau pour moi?

andauern	durer
das dauert!	ça dure!
die Dauer	la durée

rechts	à droite
die Kirche ist rechts	l'église est à droite
biegen Sie rechts ab	tournez à droite

zwölf	douze
meine Tochter ist zwölf Jahre alt	ma fille a douze ans

schlafen	dormir
ich habe die ganze Nacht über nicht geschlafen	je n'ai pas dormi de toute la nuit

begrüßen	saluer
Hallo! / Tschüss!	salut!

schmutzig	sale
schmutzige Hände haben	avoir les mains sales
der Dreck	la saleté

sans	ohne
sie ist ohne ihn abgereist	elle est partie sans lui
ohne, dass	sans que
er hat es getan, ohne dass jemand davon wusste	il l'a fait sans que personne ne le sache

außer	sauf
alle sind gekommen, bis auf ihn	tous sont venus, sauf lui

Samstag	samedi
letzten Samstag	samedi dernier
nächsten Samstag	samedi prochain

wünschen	souhaiter
ich wünsche, dass du sofort kommmst	je souhaite que tu viennes tout de suite
der Wunsch	le souhait

unter	sous
das Buch war unter dem Tisch	le livre était sous la table

die Sonne	le soleil
es ist sonnig	il y a du soleil

das Zimmer	la chambre
das Schlafzimmer	la chambre à coucher

das Glück / die Chance	la chance
viel Glück!	bonne chance!
Glück haben	avoir de la chance

kennen	connaître
kennen Sie diesen Mann?	connaissez-vous cet homme?

neben	à côté de
setz dich neben mich	assieds-toi à côté de moi

seit	depuis
seit zwei Jahren	depuis deux ans
seit langem	depuis longtemps
seit wann?	depuis quand?

letzter / letzte	dernier / dernière
zum letzten Mal	pour la dernière fois
an letzter Stelle	en dernier lieu
im letzten Jahr	l'année dernière
letzen Montag	lundi dernier

hinter	derrière
das Auto ist hinter dem Haus	la voiture est derrière la maison

was / das	que
was wünschen Sie?	que desirez-vous?
er ist größer als ich 	il est plus grand que moi
ich habe das gleiche Auto wie du	j'ai la même voiture que toi

welcher / welches	quel / quelles
welches Buch willst du?	quel livre veux-tu?
welche Blumen möchtest du?	quelles fleurs veux-tu?
wie alt ist er? Er ist zwanzig Jahre alt.	quel âge a-t-il? Il a vingt ans.

etwas	quelque chose
hast du etwas gesehen?	as-tu vu quelque chose?

einige	quelques
ich habe einige Bücher gekauft	j'ai vendu quelques livres

verstehen	comprendre
haben Sie verstanden?	avez-vous compris?

dieses / das	ce / cette
dieses Buch	ce livre
diese Bücher	ces livres
dieser Mann	cet homme
diese Frau	cette femme
das ist mein Vater	c'est mon père

das da	cela
wir haben hier zwei Bücher. Gib mir das da	nous avons deux livres ici. Donne-moi cela
was sagen Sie dazu?	qu'est-ce que vous dites à cela?

hundert	cent
können Sie mir hunder Euro geben?	pouvez-vous me donner cent euros?
hunderteins	cent un
hundertzwei	cent deux
hundertsechsundzwanzig	cent vingt-six

jeder / (ohne Substantiv)	chacun
jeder hat die Prüfung bestanden	chacun a réussi l'examen
jeder / jedes	chaque
jeden Tag	chaque jour
jedes Jahr	chaque année
jedes Mal	chaque fois

der Stuhl	la chaise
setzen Sie sich auf den Stuhl da oben	asseyez-vous sur la chaise là-haut

wissen	savoir
ich weiß, dass du recht hast	je sais que tu as raison
sie kann gut Französisch	elle sait bien parler le français
soweit ich weiß	autant que je sache

wenn	si
ich bin froh, wenn ihr kommt	je serai heureux si vous venez
ich weiß nicht, ob er kommet	je ne sais pas s'il vient
auch wenn	même si
auch wenn es regnet, komme ich	même s'il pleut, je viendrai

bedeuten	signifier
was bedeutet das Wort?	que signifie ce mot?
die Bedeutung	la signification

die Situation / die Lage	la situation
er ist in einer glücklichen Lage	il est dans une situations favorable
in der Lage sein zu	être en situation de

sechs	six
meine Tochter ist sechs Jahre alt	ma fille a six ans

sechzig	soixante
mein Vater ist sechzig Jahre alt	mon père a soixante ans

siebzig	soixante-dix
einundsiebzig	soixante et onze
zweiundsiebzig	soixante-douze

die Schwester	la sœur
Colette ist meine ältere Schwester	Colette est ma sœur aînée

der Durst	la soif
Durst haben	avoir soif

der Abend	le soir
heute Abend	ce soir
jeden Abend	tous le soirs
um neun Uhr abends	à neuf heures du soir
der Abend / (in seiner Dauer)	la soirée
den ganzen Abend	tout la soirée

hoffen	espérer
ich hoffe, dass er kommt	j'espère qu'il viendra
die Hoffnung	l'espérance / l'espoir

dann	ensuite
zuerst hat er meine Einladung angenommen, und dann hat er sie abgelehnt	d'abord il a accepté mon invitation et ensuite il l'a refusée

zusammen	ensemble
sie sind zusammen gekommen	elles sont venues ensemble

endlich	enfin
sie ist endlich angekommen	elle est enfin arrivée

wünschen	désirer
was wünschen Sie?	que désirez-vous?
er wünscht, dass du sofort kommst	il désire que tu viennes tout de suite
der Wunsch	le désir

versuchen	essayer
ich versuche es noch mal	j'essaie encore une fois
der Versuch	l'essai

und	et
du und ich	toi et moi
usw.	et cætera

der Sommer	l'été
im Sommer	en été

normal	normal / normaux
das ist normal für mich	c'est normal pour moi
normalerweise	normalement
normalerweise stehe ich um sechs auf	normalement, je me lève à six heures

neu	nouveau / nouvel

ich habe ein neues Auto gekauft	j'ai acheté une nouvelle voiture

die Handtasche	le sac à main
der Geldbeutel	le porte-monnaie
der Hut	le chapeau
die Mütze	le bonnet
der Handschuh	le gant
die Krawatte	le cravate
der Regenschirm	le parapluie
der Ring	le bague
die Uhr	le montre
die Brille	les lunettes
die Sonnenbrille	les lunettes de soleil
die Halskette	le collier
das Armband	le bracelet

familär	familial
Wie jedes Jahr gibt es wieder ein großes Familientreffen.	Comme tous les ans, il y aura une grande réunion familiale.

die Familie	la famille
die Großfamilie	la grande famille
der Papa	le papa
die Mutti	la maman
die Geschwister	les frères et sœurs
der Opa	le papi
die Oma	la mamie

zusammenleben	vivre ensemble
Sie leben seit zehn Jahren zusammen aber sind nicht verheiratet.	Ils vivent ensemble depuis dix ans mais ne sont pas mariés.

sich kümmern um	s'occuper de
Er kümmert sich um seine alten Eltern.	Il s'occupe de ses parents âgés.

die Liebe	l'amour
Kann man ohne Liebe leben?	Est-ce qu'on peut vivre sans amour?

lieben	aimer
Ich liebe dich seit dem ersten Tag.	Je t'aime depuis le premier jour.

sich lieben	s'aimer
Sie lieben sich und glauben alles voneinander zu wissen.	Ils s'aiment et pensent tout savoir l'un de l'autre.

der Hass	le haine
Ich habe keinen Hass auf ihn. Das verdient er nicht.	Je ne sens pas de haine contre lui; il n'en mérite pas.

hassen	haïr
Ich hasse ihn nicht, obwohl er mir so viel Leid angetan hat.	Je ne le hais pas, malgré tout le mal qu'il m'a fait.

verliebt	amoureux / amourese
Er ist in Anne verliebt.	Il est amoureux d'Anne.

sich verlieben	tomber amoureux
Sie hat sich in den Freund ihres Bruders verliebt.	Elle est tombée amoureuse de l'ami de son frère.

der Kuss	le baiser
Den ersten Kuss vergisst man nie.	Le premier baiser, c'est celui qu'on n'oublie jamais.

küssen	embrasser
Er hat sie mit geschlossenen Augen geküsst.	Il l'a embrassée les yeux fermés.

umarmen	prendre dans ses bras
Nachdem er sie geküsst hatte, umarmte er sie zärtlich.	Après l'avoir embrassée, il l'a prise tendrement dans ses bras.

die Hochzeit	le mariage
Mein Bruder wollte keine kirchliche Hochzeit.	Mon frère ne voulait pas de mariage à l'église.

heiraten	se marier
Pierre und seine Braut haben gespart, um heiraten zu können.	Pierre et sa fiancée ont fait des économies pour se marier.

der Ehemann	le mari
Jules ist Gisèles Ehemann.	Jules est le mari de Gisèle.

die Ehefrau	la femme
Gisèle ist die Ehefrau von Jules.	Gisèle es la femme de Jules.

das Ehepaar	le ménage
Das junge Ehepaar wohnt im Haus der Schwiegereltern.	Le jeune ménage habite dans la maison des beaux-parents.

treu	fidèle
Ich habe Sophie versprochen, ihr treu zu sein.	J'ai promis à Sophie de lui être fidèle.

untreu	infidèle
Sie hat schrecklich darunter gelitten, dass ihr Mann untreu ist.	Elle a terriblement souffert d'avoir un mari infidèle.

die Verlobung	les fiançailles
Unsere Nachbarn haben ein großes Fest zu ihrer Verlobung gegeben.	Nos voisins ont organisé une grande fête pour leurs fiançailles.

verlobt	fiancé / fiancée
Meine Schwester ist seit drei Monaten verlobt.	Ma sœur est fiancée depuis trois mois.

die Trennung	la séparation
Oft geht eine Trennung von Mann und Frau der Scheidung voraus.	La séparation entre mari et femme précède souvent le divorce.

sich trennen	se séparer
Wir haben uns getrennt, aber wir sind gute Freunde geblieben.	Nous nous sommes séparés, mais nous sommes restés bons amis.

die Freundschaft	l'amitié
Die EU basiert auf der deutsch-französischen Freundschaft.	L'UE s'appuie sur l'amitié franco-allemande.

Wir sind alte Freunde.	Nous sommes de vieux amis.

der Kumpel / Lover	le copain
die Freundin / Kumpel / Geliebte	la copine
Er hat jeden Monat eine neue Freundin.	Il change de copine tous les mois.

persönlich	personnel
Kann ich dir eine sehr persönliche Frage stellen?	Est-ce que je peux te poser une question très personnelle?

die Leute	les gens
Am Samstag sind immer viele Leute in der Stadt.	Le samedi, il y a beaucoup de gens en ville.

gemeinsam	commun / commune
Dieses Volk macht gemeinsame Sache mit den Terroristen.	Ce peuple fait cause commune avec les terroristes.

das Mitglied	le membre
Am Anfang hatte unser Tennisverein zwanzig Mitglieder.	Au début, notre club de tennis avait vingt membres.

der Nachbar	le voisin
Meine Nachbarin ist sehr neugierig und will immer alles wissen.	Ma voisine est très curieuse et veut toujours tout savoir.

der Typ / der Kerl	le type
Unser Mathelehrer ist ein sehr sympathischer Typ.	Notre prof de math, c'est un type très sympa.

das Treffen	la rencontre
Ich habe Jean auf einem internationalen Treffen kennen gelernt.	J'ai fait la connaissance de Jean lors d'une rencontre internationale.

treffen	rencontrer
Wenn ich Freunde treffe, unterhalten wir uns über dies und das.	Quan je rencontre des copains, on parle de choses et d'autres.

die Versammlung	la réunion
Ich möchte Sie alle zu unserer jährlichen Versammlung einladen.	J'aimerais vous inviter tous à notre réunion annuelle.

die Verabredung	le rendez-vous
Wir hatten eine Verabredung, aber sie ist nicht gekommen.	Nous avions rendez-vous, mais elle n'est pas venue.

sich verabreden	prendre rendez-vous
Wir haben uns verabredet, um in der Stadt Besorgungen zu machen.	Nous avons pris rendez-vous pour faire des courses en ville.

teilnehmen	participer
Ich nehme jedes Jahr an den Feiern zum 14. Juli teil.	Tous les ans, je participe aux fêtes du 14 juillet.

der Gast	l'invité
Auf meiner Hochzeit waren mehr als hundert Gäste.	À mon mariage, il y avait plus de cent invités.

einladen	invitier
Das ist nett, dass du mich zu deinem Geburtstag einlädst.	C'est gentil de m'inviter à ton anniversaire.

besuchen	aller voir
Ich besuche meine Großeltern jeden Sonntag.	Je vais voir mes grands-parents tous les dimanches.

besuchen	rendre visite
Ihr habt mich schon lange nicht mehr besucht.	Cela fait longtemps que vous ne m'avez pas rendu visite. 

vorbeikommen	passer
Er kommt jeden Tag bei mir vorbei und bringt mir die Zeitung.	Il passe tous les jours chez moi m'apporte le journal.

der Bekannte / die Bekanntschaft	la connaissance
Das ist eine alte Bekannte, die ich gestern wiedergetroffen habe.	C'est une vielle connaissance que j'ai revue hier.

der Kontakt	le contact
Ich bin mit meinem ersten Brieffreund in Kontakt geblieben.	Je suis resté en contact avec mon premier correspondant.

kontaktieren	contacter
Ich kontaktiere ihn am Ende der Ferien.	Je le contacterai à la fin des vacances.

der Freundeskreis	le groupe d'amis
Mein Sohn ist schwierig, aber er hat einen guten Freundeskreis.	Mon fils est difficile, mais il a un bon groupe d'amis.

befreundet sein	être ami
Ich bin mit meinen Kollegen vom Büro befreundet.	Je suis ami avec mes collègues de bureau.

Alle Menschen sind gleich.	Tous les hommes sont égaux.

Sie führen ein ruhiges Leben.	Ils mènent une vie tranquille.

lebend	vivant
Meine vier Großeltern sind noch am Leben.	Mes quatre grands-parents sont encore vivants.

leben	vivre
Picasso hat sehr lange gelebt.	Picasso a vécu très vieux.

die Geburt	la naissance
Die Geburt meines Babys soll am 19. Mai sein.	La naissance de mon bébé est prévue pour le 19 mai.

zur Welt kommen	naître
Ich bin an einem 29. Februar geboren.	Je suis née un 29 février.

die Kindheit	l'enfance
Er hat einen Teil seiner Kindheit in Südfrankreich verbracht.	Il a passé une partie de son enfance dans le Midi.

die Jugend	la jeunesse
Während meiner Jugend bin ich viel gereist.	Pendant ma jeunesse j'ai beaucoup voyagé.

jung / jugendlich	jeune
Du bist noch zu jung, um abends allein auszugehen.	Tu es encore trop jeune pour sortir seul le soir.

der Erwachsene	l'adulte
Dieser Film ist nur für Erwachsene.	Ce film est réservé aux adultes.

erwachsen	adulte
Wann wird man erwachsen?	Quand devient-on adulte?

das Alter	la vieillesse
Wenn man jung ist, denkt man nicht ans Alter.	Lorsqu'on est jeune, on ne pense pas à la vieillesse.

alt	vieux
Mein Großvater ist sehr alt.	Mon grand-père est très vieux.

das Alter	l'âge
Ab einem gewissen Alter zählen die Jahre doppelt.	À partir d'un certain âge, les années comptent double.

alt / nicht vieux	âgé
Es gibt immer mehr alte Leute.	Les personnes âgées sont de plus an plus nombreuses.

Mein Onkel ist schon sechzig Jahre alt.	Mon oncle a déjà soixante ans.

aufwachsen	grandir
Was bist du schnell gewachsen.	Que tu as vite grandi.

der Tod	la mort
Ich habe sie am Tag vor ihrem Tod auf der Straße getroffen.	Je l'ai rencontrée dans la rue la veille de sa mort.

tot	mort
Meine Großeltern sind schon lange tot.	Mes grands-parents sont morts depuis longtemps.

tödlich	mortel
Der Soldat starb an den Folgen einer tödlichen Verletzung.	Le soldat est mort à la suite d'une blessure mortelle.

sterben	mourir
Wenn dich diese Schlange beißt, stirbst du in wenigen Minuten.	Sie ce serpent te mord, tu meurs en quelques minutes.

das Grab	la tombe
Heute morgen sind wir zum Grab unserer Großeltern gegangen.	Ce matin, nous sommes allés sur la tombe de nos grands-parents.

die Beerdigung	l'enterrement
Das ganze Dorf war zur Beerdigung des Bürgermeisters gekommen.	Tout le village était venu à l'enterrement du maire.

enterrer	beerdigen
Sie möchte neben ihrem Mann beerdigt werden.	Elle veut être enterrée à côté de son mari.

Es gibt viel weniger Witwer als Witwen.	Il y a beaucoup moins de veufs que de veuves.

der Gedanke	la pensée
Wir komment nicht, aber wir sind in Gedanken bei euch.	Nosu ne viendrons pas mais nous serons en pensée avec vous.

denken an	penser à
Denkt daran, vor dem Weggehen das Licht auszumachen!	Pensez bien à éteindre la lumière avant de partir!

halten von	penser de
Was hältst du von meinem Vorschlag?	Que penses-tu de ma proposition?

nachdenken	réfléchir
Man muss gut nachdenken, bevor man handelt.	Il faut bien réfléchir avant d'agir.

Ich habe schöne Erinnerungen an meinen Aufenthalt in den Alpen.	J'ai de bons souveniers de mon séjour dans les Alpes.

Meine Großmutter liebt Jazz. Das erinnert sie an ihre Jugend.	Ma grand-mère ame le jazz. Ça lui rapelle sa jeunesse.

Hat sie sich an meine Adresse erinnert?	Est-ce qu'elle s'est rappelé mon adresse?

Ich habe vergessen, was "heute" auf Französisch heißt.	J'ai oublié comment on dit «heute» en français.

scheinen	sembler
Ihr scheint gut drauf zu sein. Macht das die Sonne?	Vous me semblez très en forme. C'est le soleil?

glauben	croire
Glaubst du an die Hölle?	Tu crois à l'enfer?

die Hoffnung	l'espoir
Man darf die Hoffnung nie aufgeben.	Il ne faut jamais perdre espoir.

hoffen	espérer
Ich hoffe, dass du morgen kommen kannst.	J'espère que tu pourras venir demain.

vermuten	supposer
Ich nehme an, dass sie krank ist. Sonst wäre sie da.	Je suppose qu'elle est malade. Sinon elle serait là.

wahrscheinlich	probable
Es ist wahrscheinlich, dass der Mensch zum Mars fliegt.	Il est probable que l'homme volera vers Mars.

wahrscheinlich / Adverb	probablement
Wir kommen wahrscheinlich an Weihnachten.	Nous viendrons probablement à Noël.

zweifellos / wahrscheinlich	sans doute
Das ist wahrscheinlich der schönste Strand auf Martinique.	C'est sans doute la plus belle plage de la Martinique.

vielleicht	peut-être
Deine Schwester will wahrscheinlich mitkommen.	Ta sœur veut peut-être venir avec nous.

möglich	possible
Sollte ich mich getäuscht haben? Nun ja, das wäre schon möglich.	Je me serais trompé? Après tout, c'est bien possible.

unmöglich	impossible
Es scheint mir unmöglich, dass die CD-ROM das Buch ersetzt.	Il me paraît impossible que le CD-ROM remplace le livre.

sich fragen	se demander
Ich frage mich, ob es ihm Spaß machen würde, ins Kino zu gehen.	Je me demande si cela lui ferait plaisir d'aller au cinéma.

der Sinn	le sens
Es hat keinen Sinn, Paris in einem Tag besichtigen zu wollen.	Ça n'a pas de sens de vouloir visiter Paris en un jour.

das Gefühl	le sentiment
Ich habe das Gefühl, dass man mehr für die Umwelt tun könnte.	J'ai le sentimont qu'on pourrait faire plus pour l'environnement.

die Freude	le joie
Mit Freude habe ich von deiner Hochzeit erfahren.	C'est avec joie que j'ai appris ton mariage.

das Vergnügen	le plaisir
Es ist wirklich ein Vergnügen, mit euch zu diskutieren.	C'est vraiment un plaisir de discuter avec vous.

angenehm	agréable
Dieser Sänger hat eine angenehme Stimme.	Ce chanteru a une voix agréable.

unangenehm	désagréable
Ab und zu mal nichts zu tun zu haben ist nicht unangenehm.	N'avoir rien à faire de temps en tomps n'es pas désagréable.

das Glück	le bonheur
Ich will deinem Glück nicht im Weg stehen.	Je ne veux pas être un obstacle à ton bonheur.

glücklich	heureux / heureuse
Ich hatte eine sehr glückliche Kindheit.	J'ai eu une enfance très heureuse.

unglücklich	malheureux / malheureuse
Du siehst unglücklich aus. Stimmt etwas nicht?	Tu as l'air malheureux. Ça ne va pas?

leider	malheureusement
Leider hatte ich das Thema, das drankam, nicht vorbereitet.	Je n'avais malheureusement pas refu le sujet qui est tombé.

seltsam / eigenartig	étrange
Es ist schon seltsam, dass sich niemand meldet.	C'est tout de même étrange que personne ne réponde.

das Lachen	le rire
Sein dummes Lachen gefällt mir überhaupt nicht.	Son rire bête ne me plaît pas du tout.

lachen	rire
Ich werde dir eine Geschichte erzählen, über die du lachen wirst.	Je vais te raconter une histoire qui va te faire rire.

das Lächeln	le sourire
"Ein gewisses Lächeln" ist ein gutes Buch von Françoise Sagan.	«Un certain sourire» est un bon livre de Françoise Sagan.

lächeln	sourire
Warum lächelst du? Habe ich etwas Dummes gesagt?	Pourquoi tu souris? J'ai dit une bêtise?

mögen / lieben	aimer
Ich mag Südfrankreich sehr und verbringe die ganzen Ferien dort.	J'aime bien le Midi et j'y passe toutes mes vacances.
Ich gehe gern nachts baden.	J'aime me baigner la nuit.

sehr gern haben	adorer
Man kann seine Kinder sehr gern haben, ohne sie zu verwöhnen.	On peut adorer ses enfants sans trop les gâter.

Lieblingsschausspielerin	actrice préferée
Romy Schneider war schon meine Lieblingsschauspielerin.	Romy Schneider a déjà été mon actrice préferée.

die Überraschung	la surprise
Sieh mal, ein Brief von meiner Schwester. Welch eine Überraschung!	Tiens, une lettre de ma sœur. Quelle surprise!

überraschen	surprendre
Ihre plötzliche Abreise hat uns alle sehr überrascht.	Son départ soudain nous a tous beaucoup surpris.

zufrieden	content / contente
Wir sind sehr zufrieden mit unserem neuen Auto.	Nous sommes très contents de notre nouvelle voiture.

Aus Angst, den Zug zu verpassen, ist er früh am Bahnhof gewesen.	De peur de rater son train, il est arrivé tôt à la gare.

erschrecken	fair peur à
Schreit nicht, ihr werdet ihn erschrecken.	Ne cirez pas, vous allez lui faire peur.

beunruhigt	inquiet / inquiète
Eltern sind immer beunruhigt, wenn die Kinder ausgegangen sind.	Les parents sont toujours inquiets quand les enfants sont sortis.

die Traurigkeit	la tristesse
Mit großer Traurigkeit habe ich von Jeans Tod erfahren.	C'est avec beaucoup de tristesse que j'ai appris la mort de Jean.

traurig	triste
Er ist ganz traurig, weil sein Kätzchen krank ist.	Il est tout triste parce que son petit chat est malade.

einsam / allein	seul / seule
Ich fühle mich weniger einsam, seit ich sie kennengelernt habe.	Je me sens moins seule depuis que j'ai fait leur connaissance.

schrecklich	terrible
Der Unfall war schrecklich und es gab mehrere Torte.	L'accident a été terrible et a fait plusieurs morts.

der Zweifel	la doute
Bist du dir sicher? Denn ich habe da meine Zweifel.	Tu es sûr de toi? Parce que moi, j'ai des doutes.

zweifellos	sans aucun doute
Mein Onkel ist zweifellos der beste Arzt der Stadt.	Mon oncle est sans aucun doute le meilleur médecin de la ville.

weinen	pleurer
Bei traurigen Filmen muss ich weinen.	Les films tristes me font pleurer.

die Träne	la larme
Bei der Beerdigung hatten alle Tränen in den Augen.	À l'enterrement, tout le monde avait les larmes aux yeux. 

sehen	voir
Entschuldigen Sie bitte! Ich hatte Sie nicht gesehen.	Oh pardon! Je ne vous avais pas vu!

der Blick	le regard
Sie hat einen sehr sanften Blick.	Elle a un regard très doux.

ansehen	regarder
Ich sehe mir alle Fußballspiele an.	Je regarde tous les matchs de football.

hören	entendre
Er hört auf dem linken Ohr schlecht.	Il entend mal de l'oreille gauche.

zuhören	écouter
Hör mal! Hörst du das merkwürdige Geräusch nicht?	Écoute! Tu n'entends pas un bruit bizarre?

das Geräusch	le bruit
Im Winter liebe ich das Geräusch von Schnee unter meinen Schuhen.	En hiver, j'aime le bruit de la neige sous mes chaussures.

berührer	toucher
Bitte nichts berühren.	Prière de ne toucher à rien.

der Geruch	l'odeur
Sie kann diesen Geruch nicht ausstehen.	Elle ne peut pas supporter cette odeur.

der Duft	le parfum
Ich liebe den Duft frischen Brotes.	J'aime le parfum du pain frais.

der Sinn	le sens
Der Mensch hat fünf Sinne.	L'homme a cinq sens.

die Empfindung	la sensation
Gleitschirmfliegen gibt mir ein Gefühl von Freiheit.	Faire du parapente me donne une sensation de liberté.

fühlen / riechen	sentir
Sie können anfangen. Ich fühle nichts mehr.	Vous pouvez commencer, je ne sens plus rien.

das Gespräch	la conversation
Wir hatten ein langes Gespräch über die Zukunft Europas.	Nous avons eu une longue conversation sur l'avenir de l'Europe.

Es ist angenehm, wenn man die Landessprache sprechen kann.	C'est agréable de savoir parler la langue du pays.

sagen	dire
Ärzte sagen dem Kranken nicht immer die ganze Wahrheit.	Les médecins ne disent pas toujours toute la vérité au malade.

erfahren	apprendre
Herzlichen Glückwunsch! Ich habe erfahren, dass du heiratest.	Félicitations, j'ai appris que tu allais te marier!

erzählen	raconter
Wer hat meinen Eltern erzählt, dass ich einen neuen Freund habe?	Qui a raconté à mes parents que j'ai un nouveau copain?

Kannst du die Kinder rufen? Wir essen.	Peux-tu appeler les enfants? On mange.

die Stille	le silence
Ruhe, Kinder. Ich lese euch jetzt ein Märchen vor.	Les enfants, silence! Je vais vous lire une conte de fées.

erklären	expliquer
Können Sie mir das Ende des Films erklären?	Vous pouvez m'expliquer la fin du film?

der Ausdruck	l'expression
Was bedeutet dieser Ausdruck?	Que veut dire cette expression?

ausdrücken	exprimer
Wie soll man seine Gefühle in einer Fremdsprache ausdrücken?	Comment exprimer ses sentiments dans une langue étrangère?

bitten	demander
Dürfte ich um etwas Brot bitten?	Puis-je vous demander du pain?
Fragen Sie einen Polizisten nach dem Weg!	Demandez votre chemin à un agent!

Kann ich dir eine Frage stellen?	Est-ce que je peux te poser une question?

Meine Antwort lautet nein!	Ma réponse est non!

Ich konnte die Frage des Lehrers nicht beantworten.	Je n'ai pas su répondre à la question du prof.

Verstehen Sie Deutsch?	Ja, ein bisschen.
Du hast es mir nicht gesagt. Doch, das habe ich dreimal!	Tu ne me l'as pas dit. Mais si, je te l'ai dit trois fois.

Sind Sie Französing? Nein, ich bin Deutsche.	Vous êtes Française? Non, je suis Allemande.

Ein Franzose, der Jeanne d'Arc nicht kennt? Sehr erstaunlich!	Un Français qui ne connaît pas Jeanne d'Arc? Très étonnant.

Wie bitte?	Pardon?

Keine Ursache!	De rien!
Mir reichts! Immer muss alles nach deinem Willen gehen!	J'en ai assez, il faut toujours faire ta volonté!

wollen	vouloir
Meine Eltern wollen nicht, das sich so spät nach Hause komme.

wünschen	souhaiter
Ich wünsche Ihnen allen ein gutes neues Jahr.	Je vous souaite à tous une bonne et heureuse année.

versprechen	promettre
Ich habe meinen Eltern versprochen, zu Weihnachten da zu sein.	J'ai promis à mes parents d'être là à Noël.

Das schlechte Wetter ist doch keine Entschuldigung, im Gegenteil!	Mais le mauvais temps, ce n'est pas une excuse, au contraire.

Entschuldigen Sie meine Verspätung.	Excusez mon retard.

der Befehl	l'ordre
Ich erteile nicht gern Befehle.	Je n'aime pas donner d'ordres.

erlauben	permettre
Es ist nicht erlaubt, in diesem Raum zu rauchen.	Il n'est pas permis de fumer dans cette salle.

Gestatten Sie?	Vous permettez?

dürfen	pouvoir
Darf man in französischen Gymnasien rauchen?	Est-ce qu'on peut fumer dans les lycées français?

untersagen	interdire
Es ist verboten, vor einer Garage zu parken.	Il est interdit de stationner devant un garage.

die Meinung	l'opinion
Ich habe vielleicht unrecht, aber das ist nun mal meine Meinung.	J'ai peut-être tort, mais c'est mon opinion.

die Ansicht	l'avis
Meiner Meinung nach sollten wir ihn nicht aufs Internat schicken.	À mon avis, on ne devrait pas l'envoyer en pension.

meinen	penser
Meinen Sie das, was Sie sagen, ernst?	Vous pensez sérieusement ce que vous dites?

der Rat	le conseil
Gib mir einen guten Rat, wie ich den Truthahn zubereiten soll.	Donne-moi un bon conseil pour préparer la dinde.

raten	conseiller
Was raten Sie mir, das Flugzeug oder den Zug?	Que me conseillez-vous, l'aion ou le train?

empfehlen	recommander
Der Führer empfielt das Hotel zu den drei Enten.	Le guide recommande l'Hôtel des Trois Canards.

vorschlagen	proposer
Ich schlage vor, wir machen einen Waldspaziergang.	Je propose de faire une promenade en forêt.

überzeugt	convaincu
Er ist ein überzeugter Anhänger der Europäischen Union.	C'est un partisan convaincu de l'Union européenne.

überzeugen	convaincre
Wie soll man die Leute davon überzeugen, weniger zu verbrauchen?	Comment convaincre les gens de consommer moins?

tolerieren	tolérer
Unser Lehrer duldet es nicht, wenn wir zu spät kommen.	Notre professeur netolère pas que nous arrivions en retard.

vorziehen	préférer
Mein Vater liebte mich nicht und bevorzugte meine Schwester.	Mon père ne m'aimat pas et préférait ma sœur.

einverstanden sein	accepter
Ich bin mit den Vertragsbedingungen einverstanden.	J'accepte les conditions du contrat.

zustimmen	être d'accord
Wir verstehen uns gut, obwohl wir nicht immer einer Meinung sind.	On s'entend bien, même si on n'est pas toujours d'accord.

Er muss immer recth haben.	Il veut toujours avoir raison.
Du weißt, dass du unrecht hast, also hör auf zu diskutieren.	Tu sais que tu as tort, alors arrête de discuter!

genau / genaue	précis
Ich habe eine genaue Vorstellung von meiner zukünftigen Arbeit.	J'ai une idée précise de mon futur emploi.

genau / Adverb	justement
Das trifft sich gut, genau das Buch wollte ich lesen.	Ça tombe bien, c'est justement le livre que je voulais lire.
Ganz genau!	Tout à fait!

Für mich ist diese Prüfung von allergrößter Wichtigkeit.	Pour moi, cet examen est de la plus haute importance.

Für mich ist die Familie sehr wichtig.	Pour moi, la famille, c'est important.

die Kritik	la critique
Ich hätte da eine Kritik: Die Besichtigung hat zu lange gedauert.	Moi, j'aurais une critique à faire: la visite étai trop longue.

kritisieren	critiquer
Es gibt Leute, die alles kritisieren.	Il y a des gens qui critiquent tout.

das heißt	c'est-à-dire
Sie verdient den gesetzlichen Mindestlohn, das heißt sehr wenig.	Elle gange le SMIC, c'est-à-dire très peu.

Wir könnten zum Beispiel ins Kino gehen.	On pourrait par exemple aller au cinéma.

gegen	contre
Ich war schon immer gegen die Todesstrafe, und Sie?	J'ai toujours été contre la peine de mort, et vous?

der Streit	la dispute
Sie schaffen es nicht, Auseinandersetzungen zu vermeiden.	Ils n'arrivent pas à éviter les disputes.

sich streiten 	se disputer
Es ist ormal, dass Geschwister ab und zu mal streiten.	Il est normal que frères et sœurs se disputent de temps en temps.

der Ärger	la colère
Sein Gesicht war rot vor Wut.	Son visage était rouge de colère.

sich aufregen	s'énerver
Reg dich nicht auf!	Ne t'énerve pas!

verärgert / ärgerlich	contrarié / contrariée
Papa wird sehr verärgert sein über deine Verspätung.	Papa va être très contrarié par ton retard.

zornig	furieux / furieuse
Er ist wütend, weil er nur Zweiter geworden ist.	Il est furieux d'être arrivé seulement deuxième.

wütend machen	fâcher
Sagen Sie ihm nicht, dass er dick ist. Das macht ihn wütend.	Ne lui dites pas qu'il est gros. Ça va le fâcher.

wütend werden	se fâcher
Wenn du so weitermachst, werde ich wütend.	Si tu continues comme ça, je vais me fâcher.

der Schrei	le cri
Als ich gefallen bin, habe ich einen Schrei ausgestoßen.	Lorsque je suis tombée, j'ai poussé un cri.

schreien	crier
Schrei nicht so laut. Ich bin doch nicht taub.	Ce n'est pas la peine de crier. Je ne suis pas sourd.

protestieren	protester
Die Umweltschützer protestieren gegen dieses neue Projekt.	Les écologiste protestent contre ce nouveau projet.

stören	déranger
Stört es Sie, wenn ich eine Zigarette rauche?	Ça vous dérange que je fume une cigarette?

das Geheimnis	le secret
Ihnen sage ich es, aber es ist ein Geheimnis.	Je vous le dis à vous, mais c'est un secret.

gemein	méchant / méchante
Er ist wirklich gemein zu mir gewesen.	Il a été vraiment méchant avec moi.

Gute Nacht!	Bonne nuit.

die Grüße	les amitiés
Schöne Grüße an deinen Mann!	Mes amitiés à ton mari!

das Küsschen	la bise
Ich begrüße meine Freunde mit Küsschen.	Moi, je fais la bise à mes amis.

Bis gleich!	À tout à l'heure!

Willkommen!	Bienvenue!

Sehr erfreut!	Enchanté!

Leb wohl!	Adieu!

Schönen Tag!	Bonne journée!
Schönen Abend!	Bonne soirée!

Danke, gut!	Bien merci!

Nehmen Sie doch bitte Platz!	Prenez place, je vous en prie!

Ich hätte gern...	Je voudrais...

Möchtest du...?	Est-ce que tu veux...?

Was ist los?	Qu'est qui se passe?

Bedienen Sie sich!	Servez-vous!
Bedien dich!	Sers-toi!

Ich glaube schon.	Je pense que oui.
Ich auch nicht.	Moi non plus.

Hoffentlich!	J'espère bien!
Nicht wahr?	N'est-ce pas?
Geschafft!	Ça y est!
Umso besser!	Tant mieux!
Schade!	Tant pis!
Genau!	C'est ça!

also	eh bien
Also, beeilst du dich?	Eh bien, tu te dépêches?

oder / nicht wahr	hein
Du bist mir nicht böse, oder?	Tu ne m'en veux pas, hein?

Oje!	Oh là là!

sag mal / sie mal an	tiens
Sag mal, weißt du schon das Neueste?	Tiens, tu sais la nouvelle?

Kein Problem!	Pas de problème!

Mist!	Zut!

Danke, das genügt.	merci, ça suffit.

Ach ja?	A bon?

Schade!	Dommage!

Hinaus!	Dehors!

Mit Vergnügen!	Avec plaisir!

die Tätigkeit	l'activité
Mein Bruder liebt manuelle Tätigkeiten.	Mon frère aime beaucoup les activités manuelles.

die Tag	l'action
Ich verstehe seine Handlungen nicht.	Je ne comprends pas ses actions.

Und ihr, was macht ihr heute Nachmittag?	Et vous, que faites-vous cet après-midi?

Lass am Flughafen dein Gepäck in der Gepäckaufbewahrung.	À l'aéroport, tu laisseras tes bagages à la consigne.

handeln	agir
Wir müssen sofort handeln, sonst ist es zu spät.	Il faut agir tout de suite, sinon il sera trop tard.

die Angelegenheit	l'affaire
Das sind meine Angelegenheiten und ich werde mich darum kümmern.	Ce sont mes affaires et c'est à moi de m'en occuper.

benutzen	utiliser
Er verwendet englische Wörter in seinen Nachrichten.	Il utilise des mots anglais dans ses messages.

stellen / legen / setzen	mettre
Ich haben meinen Schreibtisch vor das Fenster gestellt.	J'ai mis mon bureau devant la fenêtre.

tragen	porter
Können Sie mir helfen meinen Koffer zu tragen?	Pouvez-vous m'aider à porter ma valise?

Auf diesem Foto hält meine Mutter meine kleine Schwester im Arm.	Sur cette photo, ma mère tient ma petite sœur dans ses bras.

ziehen	tirer
Wir können diese Kiste nicht tragen, wir müssen sie ziehen.	Nous ne pouvons pas porter cette caisse, il faudra la tirer.

drücken, schieben	pousser
Du musst die Tür drücken und nicht ziehen.	Il faut pousser la porte, pas la tirer.

drücken	appuyer
Zum Öffnen auf den Knopf drücken.	Appuyer sur le bouton pour ouvrir.

drehen	tourner
Kannst du den Fernseher zu mir drehen? Ich sehe nichts.	Tu peux tourner la télé vers moi? Je ne vois rien.

brauchen / benötigen	avoir besoin de
Ich brauche Ruhe, um zu arbeiten.	Pour travailler, j'ai besoin de calme.

Ich suche nun schon seit sechs Monaten eine Stelle.	Ça fait six mois que je cherche un emploi.

finden	trouver
Sie finden die Adresse des Hotels im Telefonbuch.	Vous trouverez l'addresse de l'hôtel dans l'annuaire.

wiederfinden	retrouver
Ich habe meine Brille unter meinem Bett wiedergefunden.	J'ai retrouvé mes lunettes sous mon lit.

entfernen / wegnehmen	enlever
Nimm deine Füße da weg!	Enlève tes pieds de là!

trennen	séparer
Man sollte behinderte Kinder nicht von den anderen trennen.	On ne devrait pas séparer les enfants handicapés des autres.

vollmachen	remplir
Kannst du diese Flasche mit frischem Wasser füllen.	Peux-tu remplir cette bouteille d'eau fraîche?

verlassen	quitter
Bevor Sie das Hotel verlassen, geben Sie den Zimmerschlüssel ab.	Avant de quitter l'hôtel, rendez la clé de la chambre.

sich fertig machen	se préparer
Mach dich fertig, wir gehen in einer halben Stunde.	Prépare-toi, nous partons dans une demi-heure.

Ich wollte dich nicht wecken, du hast so gut geschlafen.	Je n'ai pas voulu te réveiller, tu dormais si bien!

einschlafen	s'endormir
Ich bin vor dem Ende der Sendung eingeschlafen.	Je me suis endormie avant la fin de l'émission.

aufwachen	se réveiller
Wegen des Gewitters sind die Kinder in der Nacht aufgewacht.	À cause de l'orage, les enfants se sont réveillés dans la nuit.

aufstehen	se lever
Ich habe beschlossen, früh aufzustehen, um Frühstück zu haben.	J'ai décidé de me lever tôt pour prendre le petit-déjeuner.

müde	fatigué / fatiguée
Die Kinder waren müde und sind schnell eingeschlafen.	Les enfants étaient fatigués et se sont vite endormis.

sich ausruhen	se reposer
Am Wochenende ruhe ich mich aus, da wird nicht gearbeitet.	Le week-end , je me repose, pas question de travailler!

Ich gehe in die Stadt. Ich muss ein paar Sachen einkaufen.	Je vais en ville. J'ai deux ou trois choses à acheter.

der Gegenstand	l'objet
Der Dachboden meiner Großeltern ist voll alter Gegenstände.

der Plan	le projet
Habt ihr schon Pläne für den Urlaub?	Vous avez des projets pour les vacances?

versuchen	essayer
Ich werde versuchen, mein Versprechen zu halten.	Je vais essayer de tenir ma promesse.

vorbereiten	préparer
Er hatte seine Rede gut vorbereitet.	Il avait bien préparé son discours.

entscheiden	décider
Wir haben beschlossen, dieses Jahr ans Meer zu fahren.	Cette année, nous avons décidé d'aller à la mer.

die Sicherheit	la certitude
Ich weiß mit Sicherheit, dass du dich verrechnet hast.	Je sais avec certitude que tut t'es trompé dans tes comptes.

Sind Sie sicher mit dem, was Sie sagen?	Vous êtes sûr de ce que vous dites?

achten auf	faire attention à
Ich habe das Radio an aber auchte nicht auf das, was ich da höre.	Je mets la radio mais ne fais pas attention à ce que j'entends.

respektieren	respecter
Oft respektiert man den strengsten Lehrer am meisten.	C'est souvent le provesseur le plus sévère qu'on respecte le plus.

die Mühe	le mal
Sie hat sich die ganze Mühe umsonst gemacht.	Elle s'est donné beaucoup de mal pour rien.

anstrengend	fatigant / fatigante
Es ist anstrengend, stundenlang vorm Computer zu sitzen.	C'est fatigant de rester des heures devant l'ordinateur.

die Hilfe	l'aide
Ohne deine Hilfe hätte ich es nicht geschafft.	Sans ton aide, je n'y serais pas arrivée.

Kannst du ihnen helfen, diesen Text zu übersetzen?	Tu peux les aider à traudire ce texte?

die Pflicht	le devoir
Glaubst du, es ist meine Pflicht, dir diese Summe zu leihen?	Crois-tu que c'est mon devoir de te prêter cette somme-là?

der Gefallen	la faveur
Darf ich Sie um einen kleinen Gefallen bitten?	Puis-je vous demander une petite faveur?

Hast du schon deinen Führerschein?	As-tu déjà ton permis de conduire?

besitzen	posséder
Meine Eltern besitzen ein Haus in Südfrankreich.	Mes parents possèdent une maison dans le Midi.

behalten	garder
Ich behalte mein altes Auto, solange es fährt.	Je garde ma vieille voiture tant qu'elle roule.

eigen	propre
Bei uns hat jeder seinen eigenen Fernseher.	Chez nous, chacun a sa propre télé.

geben	donner
Warte, ich gebe dir meine Adresse.	Attends, je vais te donner mon adresse.

geben / reichen	passer
Gibst du mir bitte den Senf?	Tu me passes le moutarde, s'il te plaît?

Du kannst mein Fahrrad nehmen.	Tu peux prendre mon vélo.

bringen / mitbringen	apporter
Kannst du mir mal meine Brille bringen?	Peux-tu m'apporter mes lunettes?

mitnehmen	emporter
Ich nehme meinen Koffer lieber mit.	Je préfère emporter ma valise avec moi.

annehmen	accepter
Ich nehme Ihre Einladung mit Vergnügen an.	J'accepte avec plaisir votre invitation.

holen	aller chercher
Kannst du mir meine Brille holen?	Peux-tu aller chercher mes lunettes?

überlassen	laisser
Kannst du mir dein Auto für drei Tage überlassen?	Est-ce que tu peux me laisser ta voiture pour trois jours?

erhalten / bekommen	recevoir
Ich hoffe, dass du meinen Brief morgen erhältst.	J'espère que tu recevras ma lettre demain.

zurückgeben	rendre
Könntest du mir mein Buch zurückgeben?	Pourrais-tu me rendre mon livere?

der Körper	le corps
der Kopf	la tête
die Stirn	le front
das Gehirn	le cerveau
das Lauge	l'œil
die Nase	le nez
der Mund	la bouche
die Lippe 	le lèvre
der Zahn	le dent
die Zunge	la langue
der Hals	le cou
der Rachen	le gorge
die Brust / der Busen	le poitrine
der Bauch	le ventre
der Rücken	le dos
die Schulter	l'épaule
der Arm	le bras
die Hand	le main
der Finger	le doigt
die Faust	le poing
das Bein	le jambe
das Knie	le genou
der Fuß	le pied
das Blut	le sang
das Herz	le cœur
die Haut	le peau
der Knochen	l'os

die Krankheit	la maladie
Er schon alle möglichen Krankheiten gehabt.	Il a déjà eu toutes les maladies possibles.

krank	malade
Sie ist während der Ferien krank geworden.	Elle est tombée malade pendant les vacances.

Mein Großvater ist noch bei bester Gesundheit.	Mon grand-père est encore en très bonne santé.

Es ist sehr gesund, Obst zu essen.	Il est très sain de manger des fruits.

Wie fühlen Sie sich heute?	Comment vous sentez-vous aujourd'hui?

gut gehen	aller bien
Und du? Wie geht es dir? Es geht mir gut.	Et toi? Comment vas-tu? Ça va bien.

körperlich	physique
Etwas körperliche Betätigung würde dir nicht schaden.	Un peu d'exercice physique ne te ferait pas de mal.

gesund werden	guérir
Ich bin endlich wieder gesund geworden.	Je suis enfin guérie.

sich erholen	se remettre
Meine Mutter hat sich sehr schnell von ihrer Operation erholt.	Ma mère s'est remise très vite de son operation.

die Kraft	la force
Das Kind hat nicht genug Kraft, um die Tür zu öffnen.	L'enant n'a pas assez de force pour ouvrir la porte.

der Schmerz	la douleur
Nach meinem Unfall hatte ich überall Schmerzen.	Après mon accident, j'avais des douleurs partout.

wehtun	faire mal
Entschuldigung, ich hoffe, ich habe Ihnen nicht wehgetan!	Excusez-moi, je ne vous ai pas fait mal, j'espère!

Schmerzen haben	avoir mal
Hast du noch Schmerzen am Knie?	As-tu encore mal au genou?

leiden	souffrir
Woran leiden Sie?	De quoi souffrez-vous?

bluten	saigner
Das ist nicht schlimm, es blutet ja nicht einmal.	Ce n'est pas bien grave, ça ne saigne même pas.

die Verletzung / die Wunde	la blessure
die Verletzung ist nicht schlimm.	La blessure n'est pas grave.

verletzt 	blessé / blessée
Alle verwundeten Soldaten wurden ins Krankenhaus gebracht.	Tous les soldats blessés ont été transportés à l'hôpital.

verletzen	blesser
Es ist ein Glück, dass niemand verletzt wurde.	C'est une chance que personne n'ait été blessé.

sich verletzen	se blesser
Pass auf, dass du dich nicht verletzt!	Fais attention à ne pas te blesser!

sich brechen	se casser
Im letzten Skiurlabu habe ich mir das Bein gebrochen.	Pendant mes dernières vacances de ski, je me suis cassé la jambe.

der Schnupfen	le rhume
erkältet	enrhumé / enrhumée
Ich gebe euch keinen Kuss, weil ich sehr erkältet bin.	Je ne vous embrasse as, car je suis très enrhumée.

husten	tousser
Das Baby hat die ganze Nacht gehustet.	La bébé a toussé toute la nuit.

das Fieber	la fièvre

schwitzen	transpirer
Man soll viel schwitzen, um das Fieber zu senken.	Il faut beaucoup transpirer pour faire tomber la fièvre.

zittern	trembler
Ihr war so kalt, dass sie zitterte.	Elle avait tellement froid qu'elle tremblait.

die Grippe	la grippe
die Kopfschmerzen	le mal de tête
die Bauchschmerzen	le mal de ventre
der Schock	le chox

der Behinderte / die Behinderte	le handicapé / la handicapée
Gibt es in diesem Restaurant Toiletten für Behinderte?	Y a-t-il dans ce restaurant des toilettes pour handicapés?

behindert	handicapé
Warum werden behinderte Kinder von den anderen getrennt?	Pourquoi les enfants handicapés sont-ils sont-ils séparés des autres?

stumm	muet / muette
Taube Kinder sind oft auch stumm.	Les enfants sourdes sont souvent aussi muets.

die Gewohnheit	l'habitude
Die Franzosen haben die Gewohnheit, abends warm zu essen.	Les Français ont l'habitude de prendre un repas chad le soir.

abhängig sein von	dépendre de
Ich war zu lange von meiner Familie abhängig.	J'ai trop longtemps dépendu de ma famille.

sich gewöhnen an	s'habituer à
Sie werden sehen, Sie gewöhnen sich daran.	Vous verrez, vous vous y habituerez.

der Raucher	le fumeur
die Raucherin	la fumeuse
der Nichtraucher	le non-fumer
die Nichtraucherin	la non-fumeuse

rauchen	fumer
Ich habe vor fünfzehn Tagen aufgehört zu rauchen.	Cela fait quinze jours que j'ai arrêté de fumer.

der Alkoholiker / die Alkoholikerin	l'alcoolique

betrunken	ivre
Ich höre lieber auf, sonst werde ich noch betrunken.	J'arrête, sinon je vais être ivre.

der Drogenabhängige	le toxicomane

die Droge	la drogue
Kokain ist ein sehr gefährliches Rauschgift.	La cocane est une drogue très dangereuse.

Drogen nehmen	se droguer
Ich glaube, meine Schwester nimmt Drogen. Sie braucht Hilfe.	Je crois que ma sœur se drogue. Elle a besoion d'aide.


